//MAP CONVERTED BY dmm2tgm.py THIS HEADER COMMENT PREVENTS RECONVERSION, DO NOT REMOVE
"a" = (
/turf/open/floor/plating,
/area/template_noop)
"b" = (
/obj/item/wrench,
/obj/effect/turf_decal/stripes/box,
/turf/open/floor/plating,
/area/template_noop)
"d" = (
/obj/machinery/light{
	dir = 4;
	icon_state = "tube"
	},
/turf/open/floor/plating,
/area/template_noop)

(1,1,1) = {"
b
a
a
"}
(2,1,1) = {"
a
a
a
"}
(3,1,1) = {"
a
a
d
"}
