//MAP CONVERTED BY dmm2tgm.py THIS HEADER COMMENT PREVENTS RECONVERSION, DO NOT REMOVE
"ae" = (
/obj/effect/turf_decal/weather/side{
	dir = 1
	},
/turf/open/floor/plating/is12/dirt,
/area/violence)
"aC" = (
/obj/structure/bonfire/prelit,
/turf/open/floor/plating/is12/dirt,
/area/violence)
"cq" = (
/obj/structure/deployable_barricade/sandbags{
	dir = 1
	},
/obj/effect/turf_decal/weather/side{
	dir = 8
	},
/turf/open/floor/plating/is12/dirt,
/area/violence)
"cu" = (
/obj/effect/turf_decal/weather/side,
/obj/machinery/light/directional/north,
/turf/open/floor/plating/is12/dirt,
/area/violence)
"cJ" = (
/obj/effect/landmark/start/combatant/red,
/turf/open/floor/plating/is12/trenchcenter,
/area/violence)
"eX" = (
/obj/structure/chair/brevno/log2,
/turf/open/floor/plating/is12/rock,
/area/violence)
"gb" = (
/obj/effect/turf_decal/is12,
/turf/open/floor/plating/is12/surface,
/area/violence)
"jI" = (
/obj/item/flashlight/flare/torch{
	pixel_x = -7;
	pixel_y = -1
	},
/obj/item/flashlight/flare/torch{
	pixel_x = 5;
	pixel_y = 3
	},
/obj/item/flashlight/flare/torch,
/turf/open/floor/plating/is12/surface,
/area/violence)
"jQ" = (
/turf/closed/mineral/ash_rock,
/area/violence)
"jS" = (
/obj/structure/deployable_barricade/sandbags,
/obj/effect/turf_decal/weather/side{
	dir = 8
	},
/turf/open/floor/plating/is12/dirt,
/area/violence)
"kA" = (
/obj/effect/turf_decal/weather/side/corner{
	dir = 8
	},
/turf/open/floor/plating/is12/dirt,
/area/violence)
"kL" = (
/obj/structure/emergency_shield/barrier,
/turf/open/floor/plating/is12/trenchcenter,
/area/violence)
"lF" = (
/obj/structure/bonfire/prelit,
/turf/open/floor/plating/is12/surface,
/area/violence)
"lG" = (
/turf/open/floor/plating/is12/dirt,
/area/violence)
"me" = (
/obj/effect/turf_decal/weather/side{
	dir = 10
	},
/turf/open/floor/plating/is12/dirt,
/area/violence)
"mW" = (
/obj/effect/turf_decal/is12{
	icon_state = "grass"
	},
/obj/structure/deployable_barricade/sandbags{
	dir = 1
	},
/turf/open/floor/plating/is12/dirt,
/area/violence)
"nj" = (
/obj/effect/turf_decal/weather/side,
/turf/open/floor/plating/is12/surface,
/area/violence)
"oJ" = (
/obj/effect/landmark/start/combatant/red,
/obj/machinery/light/red/directional/south,
/turf/open/floor/plating/is12/trenchcenter,
/area/violence)
"rz" = (
/obj/effect/turf_decal/box/red/corners{
	dir = 1
	},
/turf/open/floor/plating/is12/dirt,
/area/violence)
"rX" = (
/obj/effect/turf_decal/is12{
	icon_state = "m1"
	},
/turf/open/floor/plating/is12/surface,
/area/violence)
"sS" = (
/obj/effect/turf_decal/box/red,
/obj/effect/landmark/bomb_plant_location,
/turf/open/floor/plating/is12/dirt,
/area/violence)
"uc" = (
/obj/item/pickaxe,
/turf/open/floor/plating/is12/surface,
/area/violence)
"uz" = (
/obj/effect/turf_decal/weather/side{
	dir = 1
	},
/turf/open/floor/plating/is12/surface,
/area/violence)
"uW" = (
/obj/effect/turf_decal/weather/side{
	dir = 9
	},
/turf/open/floor/plating/is12/dirt,
/area/violence)
"vs" = (
/obj/effect/turf_decal/is12{
	icon_state = "m2"
	},
/turf/open/floor/plating/is12/surface,
/area/violence)
"wZ" = (
/obj/effect/turf_decal/weather/side{
	dir = 6
	},
/turf/open/floor/plating/is12/dirt,
/area/violence)
"xH" = (
/obj/effect/turf_decal/is12{
	icon_state = "m3"
	},
/obj/structure/bonfire/prelit,
/turf/open/floor/plating/is12/surface,
/area/violence)
"xO" = (
/obj/machinery/light/directional/west,
/turf/open/floor/plating/is12/surface,
/area/violence)
"yq" = (
/turf/open/floor/plating/is12/rock,
/area/violence)
"yr" = (
/obj/structure/deployable_barricade/sandbags,
/turf/open/floor/plating/is12/dirt,
/area/violence)
"zG" = (
/obj/structure/deployable_barricade/sandbags{
	dir = 1
	},
/obj/effect/turf_decal/weather/side{
	dir = 4
	},
/turf/open/floor/plating/is12/dirt,
/area/violence)
"BS" = (
/obj/effect/turf_decal/weather/side/corner,
/turf/open/floor/plating/is12/dirt,
/area/violence)
"BY" = (
/obj/effect/turf_decal/weather/side{
	dir = 8
	},
/turf/open/floor/plating/is12/dirt,
/area/violence)
"DW" = (
/obj/effect/turf_decal/is12{
	icon_state = "grass"
	},
/turf/open/floor/plating/is12/dirt,
/area/violence)
"ET" = (
/obj/effect/turf_decal/weather/side{
	dir = 1
	},
/obj/item/pickaxe,
/turf/open/floor/plating/is12/surface,
/area/violence)
"Fg" = (
/obj/structure/deployable_barricade/sandbags,
/obj/effect/turf_decal/weather/side{
	dir = 4
	},
/turf/open/floor/plating/is12/dirt,
/area/violence)
"GO" = (
/obj/structure/chair/brevno{
	dir = 1
	},
/turf/open/floor/plating/is12/rock,
/area/violence)
"Hh" = (
/turf/closed/indestructible/sandstone,
/area/violence)
"IE" = (
/obj/effect/turf_decal/box/red/corners{
	dir = 4
	},
/turf/open/floor/plating/is12/dirt,
/area/violence)
"Jl" = (
/obj/effect/turf_decal/weather/side,
/turf/open/floor/plating/is12/dirt,
/area/violence)
"LA" = (
/turf/closed/indestructible/riveted/dirtystone,
/area/violence)
"Mo" = (
/obj/structure/table/rospilovo,
/turf/open/floor/plating/is12/rock,
/area/violence)
"Mp" = (
/obj/effect/turf_decal/box/red/corners,
/turf/open/floor/plating/is12/dirt,
/area/violence)
"NJ" = (
/obj/effect/turf_decal/weather/side/corner{
	dir = 1
	},
/turf/open/floor/plating/is12/dirt,
/area/violence)
"Op" = (
/obj/structure/chair/brevno,
/turf/open/floor/plating/is12/rock,
/area/violence)
"OB" = (
/obj/effect/landmark/start/combatant/blue,
/turf/open/floor/plating/is12/trenchcenter,
/area/violence)
"PF" = (
/obj/effect/turf_decal/is12{
	icon_state = "m4"
	},
/turf/open/floor/plating/is12/surface,
/area/violence)
"Rt" = (
/obj/structure/deployable_barricade/sandbags{
	dir = 1
	},
/turf/open/floor/plating/is12/dirt,
/area/violence)
"Sc" = (
/obj/effect/turf_decal/weather/side{
	dir = 4
	},
/turf/open/floor/plating/is12/dirt,
/area/violence)
"Ty" = (
/obj/effect/baseturf_helper/dune,
/turf/closed/indestructible/riveted/dirtystone,
/area/violence)
"Um" = (
/obj/effect/turf_decal/weather/side{
	dir = 5
	},
/turf/open/floor/plating/is12/dirt,
/area/violence)
"Ut" = (
/obj/effect/landmark/start/combatant/blue,
/obj/machinery/light/cold/directional/north,
/turf/open/floor/plating/is12/trenchcenter,
/area/violence)
"UL" = (
/turf/open/floor/plating/is12/surface,
/area/violence)
"Vr" = (
/obj/effect/turf_decal/weather/side{
	dir = 1
	},
/obj/machinery/light/cold/directional/south,
/turf/open/floor/plating/is12/dirt,
/area/violence)
"Vz" = (
/obj/effect/turf_decal/box/red/corners{
	dir = 8
	},
/turf/open/floor/plating/is12/dirt,
/area/violence)
"VH" = (
/obj/structure/bonfire/prelit,
/turf/open/floor/plating/is12/rock,
/area/violence)
"Wo" = (
/obj/structure/chair/brevno/log2{
	dir = 1
	},
/turf/open/floor/plating/is12/rock,
/area/violence)
"WY" = (
/obj/machinery/light/directional/east,
/turf/open/floor/plating/is12/surface,
/area/violence)
"XP" = (
/obj/effect/turf_decal/weather/side/corner{
	dir = 4
	},
/turf/open/floor/plating/is12/dirt,
/area/violence)

(1,1,1) = {"
Ty
LA
LA
LA
LA
LA
LA
LA
LA
LA
LA
LA
LA
LA
LA
LA
LA
LA
LA
LA
LA
LA
LA
LA
LA
LA
LA
LA
LA
LA
LA
LA
LA
LA
LA
LA
LA
LA
LA
LA
LA
LA
LA
LA
LA
LA
LA
LA
LA
LA
LA
LA
LA
LA
LA
LA
LA
LA
LA
LA
LA
LA
LA
LA
LA
LA
LA
LA
LA
LA
LA
LA
LA
LA
LA
LA
LA
LA
LA
LA
"}
(2,1,1) = {"
LA
wZ
Sc
Sc
Sc
Sc
Sc
Sc
Sc
Sc
Fg
nj
UL
UL
xO
UL
UL
UL
jQ
jQ
jQ
jQ
jQ
jQ
jQ
jQ
jQ
jQ
jQ
jQ
UL
jQ
jQ
jQ
jQ
jQ
jQ
jQ
jQ
jQ
jQ
jQ
jQ
jQ
jQ
jQ
jQ
jQ
jQ
UL
jQ
jQ
jQ
jQ
jQ
jQ
jQ
jQ
jQ
jQ
UL
UL
UL
UL
UL
xO
UL
UL
uz
zG
Sc
Sc
Sc
Sc
Sc
Sc
Sc
Sc
Um
LA
"}
(3,1,1) = {"
LA
Jl
lG
lG
lG
lG
lG
lG
yr
lG
lG
nj
UL
UL
UL
UL
UL
jQ
jQ
jQ
jQ
jQ
jQ
UL
UL
UL
UL
jQ
jQ
jQ
UL
jQ
jQ
UL
UL
UL
jQ
UL
UL
UL
jQ
UL
UL
UL
jQ
UL
UL
UL
jQ
UL
jQ
jQ
jQ
jQ
UL
UL
UL
jQ
jQ
jQ
jQ
jQ
UL
UL
UL
UL
UL
UL
uz
lG
lG
Rt
lG
lG
DW
lG
lG
lG
ae
LA
"}
(4,1,1) = {"
LA
cu
lG
lG
lG
lG
lG
lG
yr
lG
lG
nj
UL
UL
UL
UL
UL
jQ
jQ
jQ
jQ
jQ
UL
UL
UL
UL
UL
UL
jQ
jQ
UL
UL
jQ
UL
jQ
UL
jQ
UL
jQ
UL
jQ
UL
jQ
UL
jQ
UL
jQ
UL
jQ
jQ
jQ
jQ
jQ
UL
UL
UL
UL
UL
jQ
jQ
jQ
jQ
jQ
UL
UL
UL
UL
gb
uz
lG
lG
Rt
lG
lG
aC
lG
lG
lG
Vr
LA
"}
(5,1,1) = {"
LA
Jl
DW
lG
lG
lG
lG
lG
yr
lG
lG
nj
uc
UL
UL
UL
UL
UL
UL
jQ
jQ
jQ
UL
UL
UL
UL
UL
UL
UL
jQ
UL
gb
jQ
UL
jQ
UL
jQ
lG
jQ
UL
jQ
UL
jQ
UL
jQ
UL
jQ
UL
jQ
jQ
jQ
jQ
jQ
UL
UL
UL
UL
UL
jQ
jQ
jQ
jQ
jQ
UL
UL
UL
UL
UL
ET
lG
lG
Rt
lG
lG
lG
lG
lG
lG
ae
LA
"}
(6,1,1) = {"
LA
Jl
lG
lG
lG
lG
lG
lG
yr
lG
lG
nj
UL
UL
UL
UL
UL
UL
UL
jQ
jQ
jQ
jQ
jQ
jQ
UL
UL
UL
UL
jQ
UL
UL
jQ
UL
jQ
UL
lG
lG
lG
lG
jQ
UL
jQ
UL
jQ
UL
jQ
UL
jQ
jQ
jQ
jQ
UL
UL
UL
UL
UL
jQ
jQ
jQ
jQ
jQ
UL
UL
UL
UL
UL
UL
uz
lG
lG
Rt
lG
lG
lG
lG
lG
lG
ae
LA
"}
(7,1,1) = {"
LA
Jl
kA
BY
BY
BY
BY
BY
BY
NJ
yr
nj
UL
UL
UL
UL
UL
UL
UL
UL
UL
jQ
jQ
jQ
jQ
UL
UL
UL
UL
jQ
UL
lF
jQ
UL
jQ
UL
jQ
lG
lG
lG
lG
UL
jQ
UL
UL
UL
jQ
UL
jQ
UL
jQ
jQ
jQ
UL
UL
UL
jQ
jQ
jQ
jQ
UL
UL
UL
UL
UL
UL
UL
UL
uz
Rt
kA
BY
BY
BY
BY
BY
BY
NJ
ae
LA
"}
(8,1,1) = {"
LA
Jl
ae
Hh
kL
kL
kL
kL
Hh
Jl
yr
nj
UL
UL
UL
UL
UL
UL
UL
UL
UL
UL
UL
jQ
jQ
jQ
UL
UL
jQ
jQ
UL
UL
jQ
UL
jQ
UL
jQ
LA
yq
yq
LA
LA
LA
jQ
jQ
jQ
jQ
UL
jQ
UL
jQ
jQ
jQ
jQ
jQ
jQ
jQ
jQ
jQ
UL
UL
UL
UL
UL
UL
UL
UL
UL
uz
Rt
ae
Hh
kL
kL
kL
kL
Hh
Jl
ae
LA
"}
(9,1,1) = {"
LA
cu
ae
kL
cJ
cJ
cJ
oJ
Hh
Jl
yr
nj
UL
UL
jI
UL
UL
jQ
jQ
jQ
UL
UL
UL
jQ
jQ
jQ
jQ
jQ
jQ
jQ
UL
UL
jQ
UL
jQ
UL
jQ
LA
Mo
yq
Op
yq
LA
UL
jQ
UL
UL
UL
jQ
UL
jQ
jQ
jQ
jQ
jQ
jQ
jQ
jQ
UL
UL
UL
UL
UL
UL
UL
uc
UL
UL
uz
Rt
ae
Hh
Ut
OB
OB
OB
kL
Jl
Vr
LA
"}
(10,1,1) = {"
LA
Jl
ae
kL
cJ
cJ
cJ
cJ
Hh
Jl
yr
nj
UL
UL
lF
UL
jQ
jQ
jQ
jQ
jQ
UL
UL
UL
UL
jQ
jQ
jQ
jQ
jQ
UL
jQ
jQ
UL
jQ
UL
jQ
LA
yq
yq
eX
VH
LA
UL
jQ
UL
jQ
jQ
jQ
UL
jQ
jQ
jQ
jQ
jQ
jQ
UL
UL
UL
UL
jQ
jQ
UL
UL
UL
jI
UL
UL
uz
Rt
ae
Hh
OB
OB
OB
OB
kL
Jl
ae
LA
"}
(11,1,1) = {"
LA
Jl
ae
kL
cJ
cJ
cJ
cJ
Hh
Jl
yr
nj
UL
UL
uc
UL
jQ
jQ
jQ
jQ
jQ
jQ
UL
UL
UL
UL
jQ
jQ
jQ
jQ
UL
UL
UL
UL
jQ
UL
jQ
LA
VH
GO
yq
yq
LA
UL
jQ
UL
jQ
jQ
UL
UL
jQ
jQ
jQ
jQ
jQ
UL
UL
UL
UL
jQ
jQ
jQ
jQ
UL
PF
xH
UL
UL
uz
Rt
ae
Hh
OB
OB
OB
OB
kL
Jl
ae
LA
"}
(12,1,1) = {"
LA
cu
ae
kL
cJ
cJ
cJ
oJ
Hh
Jl
yr
nj
UL
UL
UL
jQ
jQ
UL
UL
UL
jQ
jQ
jQ
UL
UL
UL
UL
jQ
jQ
jQ
UL
jQ
jQ
jQ
jQ
UL
jQ
LA
yq
Wo
yq
Mo
LA
UL
jQ
UL
jQ
jQ
lF
UL
jQ
jQ
jQ
jQ
UL
UL
UL
UL
jQ
jQ
jQ
jQ
jQ
UL
vs
rX
UL
UL
uz
Rt
ae
Hh
Ut
OB
OB
OB
kL
Jl
Vr
LA
"}
(13,1,1) = {"
LA
Jl
ae
Hh
kL
kL
kL
kL
Hh
Jl
yr
nj
UL
UL
UL
jQ
jQ
UL
UL
UL
UL
UL
jQ
jQ
jQ
UL
UL
UL
UL
jQ
UL
jQ
jQ
UL
UL
UL
jQ
LA
LA
LA
yq
yq
LA
UL
jQ
UL
jQ
jQ
UL
gb
jQ
jQ
jQ
UL
UL
UL
UL
jQ
jQ
jQ
jQ
jQ
jQ
jQ
UL
UL
UL
uc
uz
Rt
ae
Hh
kL
kL
kL
kL
Hh
Jl
ae
LA
"}
(14,1,1) = {"
LA
Jl
XP
Sc
Sc
Sc
Sc
Sc
Sc
BS
yr
nj
UL
UL
UL
jQ
jQ
jQ
UL
UL
UL
UL
UL
UL
jQ
jQ
jQ
UL
UL
UL
UL
jQ
jQ
UL
jQ
jQ
jQ
jQ
jQ
lG
lG
lG
lG
UL
jQ
UL
jQ
jQ
UL
UL
jQ
UL
UL
UL
UL
jQ
jQ
jQ
jQ
UL
UL
jQ
jQ
jQ
UL
UL
UL
UL
uz
Rt
XP
Sc
Sc
Sc
Sc
Sc
Sc
BS
ae
LA
"}
(15,1,1) = {"
LA
Jl
lG
lG
lG
lG
lG
lG
yr
lG
lG
nj
uc
UL
UL
UL
jQ
jQ
jQ
UL
UL
UL
UL
UL
jQ
jQ
jQ
jQ
jQ
UL
UL
jQ
jQ
UL
jQ
UL
UL
UL
jQ
lG
lG
lG
lG
UL
UL
UL
jQ
jQ
jQ
UL
UL
UL
UL
UL
jQ
jQ
jQ
UL
UL
UL
UL
jQ
jQ
jQ
UL
UL
gb
UL
uz
lG
lG
Rt
lG
lG
lG
lG
lG
lG
ae
LA
"}
(16,1,1) = {"
LA
Jl
lG
lG
lG
lG
lG
lG
yr
lG
lG
nj
UL
gb
UL
UL
jQ
jQ
jQ
UL
UL
UL
UL
UL
UL
jQ
jQ
jQ
jQ
jQ
jQ
jQ
jQ
UL
jQ
UL
jQ
UL
jQ
UL
lG
UL
jQ
UL
jQ
UL
jQ
jQ
jQ
UL
UL
jQ
jQ
jQ
jQ
jQ
UL
UL
UL
UL
jQ
jQ
jQ
UL
UL
UL
UL
UL
uz
lG
lG
Rt
lG
Mp
lG
IE
lG
lG
ae
LA
"}
(17,1,1) = {"
LA
cu
lG
lG
lG
aC
lG
lG
yr
lG
lG
nj
UL
UL
UL
UL
UL
jQ
jQ
jQ
jQ
jQ
UL
UL
UL
UL
UL
jQ
jQ
jQ
jQ
jQ
jQ
UL
jQ
UL
jQ
UL
jQ
UL
jQ
UL
jQ
UL
jQ
UL
jQ
jQ
jQ
UL
jQ
jQ
jQ
jQ
jQ
jQ
UL
UL
UL
jQ
jQ
jQ
UL
UL
UL
UL
UL
UL
uz
lG
lG
mW
lG
lG
sS
lG
lG
lG
Vr
LA
"}
(18,1,1) = {"
LA
Jl
lG
DW
lG
lG
lG
lG
yr
lG
lG
nj
UL
UL
UL
UL
UL
UL
UL
jQ
jQ
jQ
jQ
jQ
jQ
jQ
jQ
jQ
jQ
jQ
UL
jQ
jQ
UL
UL
UL
jQ
UL
UL
UL
jQ
UL
UL
UL
jQ
UL
UL
UL
UL
UL
jQ
jQ
jQ
jQ
jQ
jQ
jQ
UL
jQ
jQ
jQ
UL
UL
UL
UL
UL
UL
UL
uz
lG
lG
Rt
lG
Vz
lG
rz
lG
lG
ae
LA
"}
(19,1,1) = {"
LA
me
BY
BY
BY
BY
BY
BY
BY
BY
jS
nj
UL
UL
WY
UL
UL
UL
UL
UL
UL
jQ
jQ
jQ
jQ
jQ
jQ
jQ
jQ
jQ
UL
jQ
jQ
jQ
jQ
jQ
jQ
jQ
jQ
jQ
jQ
jQ
jQ
jQ
jQ
jQ
jQ
jQ
jQ
UL
jQ
jQ
jQ
jQ
jQ
jQ
jQ
jQ
jQ
jQ
jQ
jQ
UL
UL
UL
WY
UL
UL
uz
cq
BY
BY
BY
BY
BY
BY
BY
BY
uW
LA
"}
(20,1,1) = {"
LA
LA
LA
LA
LA
LA
LA
LA
LA
LA
LA
LA
LA
LA
LA
LA
LA
LA
LA
LA
LA
LA
LA
LA
LA
LA
LA
LA
LA
LA
LA
LA
LA
LA
LA
LA
LA
LA
LA
LA
LA
LA
LA
LA
LA
LA
LA
LA
LA
LA
LA
LA
LA
LA
LA
LA
LA
LA
LA
LA
LA
LA
LA
LA
LA
LA
LA
LA
LA
LA
LA
LA
LA
LA
LA
LA
LA
LA
LA
LA
"}
