//MAP CONVERTED BY dmm2tgm.py THIS HEADER COMMENT PREVENTS RECONVERSION, DO NOT REMOVE
"b" = (
/obj/effect/spawner/structure/window/reinforced,
/turf/open/floor/plating,
/area/violence)
"g" = (
/turf/closed/indestructible/reinforced,
/area/violence)
"h" = (
/obj/effect/landmark/start/combatant/blue,
/turf/open/floor/plasteel/bluespace,
/area/violence)
"j" = (
/turf/open/floor/plasteel/monofloor/dark,
/area/violence)
"k" = (
/mob/living/carbon/human/raper,
/turf/open/floor/light/colour_cycle/dancefloor_b,
/area/violence)
"n" = (
/obj/effect/spawner/structure/window/reinforced,
/obj/structure/emergency_shield/barrier,
/turf/open/floor/plating,
/area/violence)
"o" = (
/obj/structure/mystery_box/guns,
/turf/open/floor/plasteel/monofloor/dark,
/area/violence)
"p" = (
/obj/effect/landmark/start/combatant/red,
/turf/open/floor/plasteel/bluespace,
/area/violence)
"r" = (
/mob/living/carbon/human/raper,
/turf/open/floor/light/colour_cycle/dancefloor_a,
/area/violence)
"s" = (
/turf/open/floor/light/colour_cycle/dancefloor_a,
/area/violence)
"v" = (
/turf/closed/indestructible/black,
/area/violence)
"x" = (
/obj/effect/turf_decal/box/red/corners{
	dir = 4
	},
/turf/open/floor/plasteel/monofloor/dark,
/area/violence)
"A" = (
/obj/effect/turf_decal/box/red/corners{
	dir = 1
	},
/turf/open/floor/plasteel/monofloor/dark,
/area/violence)
"E" = (
/obj/effect/turf_decal/box/red,
/obj/effect/landmark/bomb_plant_location,
/turf/open/floor/plasteel/monofloor/dark,
/area/violence)
"H" = (
/turf/closed/wall/r_wall,
/area/violence)
"J" = (
/obj/effect/turf_decal/box/red/corners,
/turf/open/floor/plasteel/monofloor/dark,
/area/violence)
"M" = (
/obj/effect/turf_decal/box/red/corners{
	dir = 8
	},
/turf/open/floor/plasteel/monofloor/dark,
/area/violence)
"O" = (
/turf/open/floor/light/colour_cycle/dancefloor_b,
/area/violence)
"S" = (
/obj/effect/baseturf_helper/dune,
/turf/closed/indestructible/black,
/area/violence)
"T" = (
/turf/open/water/xen_acid,
/area/violence)
"U" = (
/turf/closed/wall/mineral/titanium,
/area/violence)

(1,1,1) = {"
S
v
v
v
v
v
v
v
v
v
v
v
v
v
v
v
v
v
v
v
v
v
v
v
v
v
v
v
v
v
v
v
v
v
v
v
v
v
v
v
"}
(2,1,1) = {"
v
U
U
U
U
U
H
H
H
H
U
U
U
U
H
H
H
H
U
U
U
U
H
H
H
H
U
U
U
U
U
U
U
U
U
U
U
U
U
v
"}
(3,1,1) = {"
v
U
T
T
T
T
j
j
j
j
T
T
T
T
j
j
j
j
n
T
T
n
j
j
j
j
T
T
T
T
T
T
T
T
T
T
T
T
U
v
"}
(4,1,1) = {"
v
U
T
T
T
T
j
j
j
j
T
T
T
T
j
j
j
j
n
T
T
n
j
j
j
j
T
T
T
T
T
T
T
T
T
T
T
T
U
v
"}
(5,1,1) = {"
v
U
T
T
T
T
j
j
j
j
T
T
T
T
j
j
j
j
n
T
T
n
j
j
j
j
T
T
T
T
T
T
T
T
T
T
T
T
U
v
"}
(6,1,1) = {"
v
U
T
T
T
T
j
j
j
j
T
T
T
T
j
j
j
j
n
T
T
n
j
j
j
j
T
T
T
g
g
g
g
g
g
T
T
T
U
v
"}
(7,1,1) = {"
v
H
j
j
j
j
j
j
j
j
T
T
T
T
j
j
j
j
n
T
T
n
j
j
j
j
T
T
T
n
p
p
p
p
g
T
T
T
U
v
"}
(8,1,1) = {"
v
H
j
j
j
j
j
H
H
j
T
T
T
T
j
H
H
j
n
T
T
n
j
H
H
j
T
T
T
n
p
p
p
p
g
T
T
T
U
v
"}
(9,1,1) = {"
v
H
j
j
j
j
j
H
H
j
T
T
T
T
j
H
H
j
n
T
T
n
j
H
H
j
T
T
T
n
p
p
p
p
g
T
T
T
U
v
"}
(10,1,1) = {"
v
H
j
j
j
j
j
j
j
j
T
T
T
T
j
j
j
j
n
T
T
n
j
j
j
j
T
T
T
n
p
p
p
p
g
T
T
T
U
v
"}
(11,1,1) = {"
v
U
T
T
T
T
j
j
j
j
T
T
T
T
T
T
T
T
n
T
T
n
j
j
j
j
T
T
T
n
n
n
n
n
g
T
T
T
U
v
"}
(12,1,1) = {"
v
U
T
T
T
T
j
j
j
j
T
T
T
T
T
T
T
T
n
T
T
n
j
j
j
j
T
T
T
T
T
T
T
T
T
T
T
T
U
v
"}
(13,1,1) = {"
v
U
T
T
T
T
j
j
j
j
T
T
T
T
T
T
T
T
n
T
T
n
j
j
j
j
T
T
T
T
T
T
T
T
T
T
T
T
U
v
"}
(14,1,1) = {"
v
U
T
T
T
T
j
j
j
j
T
T
T
T
T
T
T
T
n
T
T
n
j
j
j
j
T
T
T
T
T
T
T
T
T
T
T
T
U
v
"}
(15,1,1) = {"
v
U
T
T
T
T
j
j
j
j
T
T
T
T
T
T
T
T
n
T
T
n
j
j
j
j
T
T
T
T
T
T
T
T
T
T
T
T
U
v
"}
(16,1,1) = {"
v
H
j
j
j
j
j
j
j
j
j
j
j
j
j
j
j
j
g
g
g
g
j
j
j
j
j
j
j
j
j
j
j
j
j
j
j
j
H
v
"}
(17,1,1) = {"
v
H
j
j
j
j
j
H
H
j
j
j
j
j
j
j
j
j
b
O
s
b
j
j
j
j
j
j
j
j
j
H
H
j
j
j
j
j
H
v
"}
(18,1,1) = {"
v
H
j
j
j
j
j
H
H
j
j
j
j
j
j
j
o
j
b
s
O
b
j
j
j
j
j
j
j
j
j
H
H
j
j
j
j
j
H
v
"}
(19,1,1) = {"
v
H
j
j
j
j
j
j
j
j
j
j
j
j
j
j
j
j
g
g
g
g
j
j
j
j
j
j
j
j
j
j
j
j
j
j
j
j
H
v
"}
(20,1,1) = {"
v
H
j
j
j
j
j
o
j
j
T
T
T
T
j
j
j
j
g
k
r
g
j
j
j
j
T
T
T
T
j
j
j
j
j
j
j
j
H
v
"}
(21,1,1) = {"
v
H
j
j
j
j
j
j
j
j
T
T
T
T
j
j
j
j
g
r
k
g
j
j
j
j
T
T
T
T
j
j
o
j
j
j
j
j
H
v
"}
(22,1,1) = {"
v
H
j
j
j
j
j
j
j
j
j
j
j
j
j
j
j
j
g
g
g
g
j
j
j
j
j
j
j
j
j
j
j
j
j
j
j
j
H
v
"}
(23,1,1) = {"
v
H
j
j
j
j
j
H
H
j
j
j
j
j
J
j
x
j
b
O
s
b
j
o
j
j
j
j
j
j
j
H
H
j
j
j
j
j
H
v
"}
(24,1,1) = {"
v
H
j
j
j
j
j
H
H
j
j
j
j
j
j
E
j
j
b
s
O
b
j
j
j
j
j
j
j
j
j
H
H
j
j
j
j
j
H
v
"}
(25,1,1) = {"
v
H
j
j
j
j
j
j
j
j
j
j
j
j
M
j
A
j
g
g
g
g
j
j
j
j
j
j
j
j
j
j
j
j
j
j
j
j
H
v
"}
(26,1,1) = {"
v
U
T
T
T
T
T
T
T
T
T
T
T
T
j
j
j
j
n
T
T
n
T
T
T
T
T
T
T
T
j
j
j
j
T
T
T
T
U
v
"}
(27,1,1) = {"
v
U
T
T
T
T
T
T
T
T
T
T
T
T
j
j
j
j
n
T
T
n
T
T
T
T
T
T
T
T
j
j
j
j
T
T
T
T
U
v
"}
(28,1,1) = {"
v
U
T
T
T
T
T
T
T
T
T
T
T
T
j
j
j
j
n
T
T
n
T
T
T
T
T
T
T
T
j
j
j
j
T
T
T
T
U
v
"}
(29,1,1) = {"
v
U
T
T
T
T
T
T
T
T
T
T
T
T
j
j
j
j
n
T
T
n
T
T
T
T
T
T
T
T
j
j
j
j
T
T
T
T
U
v
"}
(30,1,1) = {"
v
U
T
T
T
g
n
n
n
n
n
T
T
T
j
j
j
j
n
T
T
n
T
T
T
T
T
T
T
T
j
j
j
j
T
T
T
T
U
v
"}
(31,1,1) = {"
v
U
T
T
T
g
h
h
h
h
n
T
T
T
j
j
j
j
n
T
T
n
j
j
j
j
T
T
T
T
j
j
j
j
j
j
j
j
H
v
"}
(32,1,1) = {"
v
U
T
T
T
g
h
h
h
h
n
T
T
T
j
H
H
j
n
T
T
n
j
H
H
j
T
T
T
T
j
H
H
j
j
j
j
j
H
v
"}
(33,1,1) = {"
v
U
T
T
T
g
h
h
h
h
n
T
T
T
j
H
H
j
n
T
T
n
j
H
H
j
T
T
T
T
j
H
H
j
j
j
j
j
H
v
"}
(34,1,1) = {"
v
U
T
T
T
g
h
h
h
h
n
T
T
T
j
j
j
j
n
T
T
n
j
j
j
j
T
T
T
T
j
j
j
j
j
j
j
j
H
v
"}
(35,1,1) = {"
v
U
T
T
T
g
g
g
g
g
g
T
T
T
j
j
j
j
n
T
T
n
j
j
j
j
T
T
T
T
j
j
j
j
T
T
T
T
U
v
"}
(36,1,1) = {"
v
U
T
T
T
T
T
T
T
T
T
T
T
T
j
j
j
j
n
T
T
n
j
j
j
j
T
T
T
T
j
j
j
j
T
T
T
T
U
v
"}
(37,1,1) = {"
v
U
T
T
T
T
T
T
T
T
T
T
T
T
j
j
j
j
n
T
T
n
j
j
j
j
T
T
T
T
j
j
j
j
T
T
T
T
U
v
"}
(38,1,1) = {"
v
U
T
T
T
T
T
T
T
T
T
T
T
T
j
j
j
j
n
T
T
n
j
j
j
j
T
T
T
T
j
j
j
j
T
T
T
T
U
v
"}
(39,1,1) = {"
v
U
U
U
U
U
U
U
U
U
U
U
U
U
H
H
H
H
U
U
U
U
H
H
H
H
U
U
U
U
H
H
H
H
U
U
U
U
U
v
"}
(40,1,1) = {"
v
v
v
v
v
v
v
v
v
v
v
v
v
v
v
v
v
v
v
v
v
v
v
v
v
v
v
v
v
v
v
v
v
v
v
v
v
v
v
v
"}
