//MAP CONVERTED BY dmm2tgm.py THIS HEADER COMMENT PREVENTS RECONVERSION, DO NOT REMOVE
"a" = (
/turf/closed/dz/normal/cyber,
/area/violence)
"b" = (
/obj/structure/emergency_shield/barrier,
/turf/open/floor/dz/cyber,
/area/violence)
"c" = (
/obj/effect/particle_cyberspess,
/turf/open/floor/dz/cyber,
/area/violence)
"e" = (
/obj/effect/turf_decal/box/red/corners,
/turf/open/floor/dz/green,
/area/violence)
"f" = (
/obj/effect/landmark/start/combatant/blue,
/turf/open/floor/dz/green,
/area/violence)
"g" = (
/turf/template_noop,
/area/template_noop)
"j" = (
/obj/effect/mapping_helpers/turf_rotation,
/turf/open/floor/dz/hot_plates,
/area/violence)
"l" = (
/obj/effect/baseturf_helper/dune,
/turf/closed/dz/normal/cyber,
/area/violence)
"o" = (
/obj/effect/turf_decal/box/red/corners{
	dir = 1
	},
/turf/open/floor/dz/green,
/area/violence)
"q" = (
/obj/effect/particle_cyberspess,
/turf/open/floor/dz/green,
/area/violence)
"r" = (
/obj/effect/turf_decal/box/red/corners{
	dir = 8
	},
/turf/open/floor/dz/green,
/area/violence)
"s" = (
/obj/effect/mapping_helpers/turf_rotation{
	timer = 5
	},
/turf/open/floor/dz/corruption,
/area/violence)
"v" = (
/turf/open/floor/dz/cyber,
/area/violence)
"w" = (
/turf/open/floor/dz/green,
/area/violence)
"z" = (
/obj/effect/landmark/start/combatant/blue,
/obj/effect/particle_cyberspess,
/turf/open/floor/dz/green,
/area/violence)
"A" = (
/obj/effect/landmark/start/combatant/red,
/obj/effect/particle_cyberspess,
/turf/open/floor/dz/green,
/area/violence)
"B" = (
/obj/structure/sign/dz,
/turf/closed/dz/normal/cyber,
/area/violence)
"C" = (
/obj/structure/sign/dz/end,
/turf/closed/dz/normal/cyber,
/area/violence)
"D" = (
/obj/effect/powerup/health,
/turf/open/floor/dz/trippy_green,
/area/violence)
"G" = (
/obj/effect/powerup/ammo,
/turf/open/floor/dz/trippy_green,
/area/violence)
"H" = (
/obj/effect/landmark/start/combatant/red,
/turf/open/floor/dz/green,
/area/violence)
"K" = (
/obj/effect/landmark/bomb_plant_location,
/obj/effect/turf_decal/box/red,
/turf/open/floor/dz/trippy_green,
/area/violence)
"O" = (
/obj/effect/landmark/start/combatant/blue,
/turf/open/floor/dz/trippy_green,
/area/violence)
"P" = (
/obj/structure/sign/dz/middle,
/turf/closed/dz/normal/cyber,
/area/violence)
"Q" = (
/obj/effect/landmark/start/combatant/red,
/turf/open/floor/dz/trippy_green,
/area/violence)
"W" = (
/obj/effect/turf_decal/box/red/corners{
	dir = 4
	},
/turf/open/floor/dz/green,
/area/violence)

(1,1,1) = {"
l
a
a
a
a
a
a
a
a
a
a
a
a
a
a
g
g
g
g
g
g
g
g
g
g
g
g
g
g
g
g
g
g
g
g
g
g
g
g
a
a
a
a
a
a
a
a
a
a
a
a
a
a
a
"}
(2,1,1) = {"
a
v
v
v
v
v
v
a
j
j
j
j
j
j
a
a
a
a
a
a
a
a
a
a
a
a
a
a
a
a
a
a
a
a
a
a
a
a
a
a
j
j
j
j
j
j
a
v
v
v
v
v
v
a
"}
(3,1,1) = {"
a
v
v
v
v
v
v
v
j
j
j
j
j
j
a
v
v
v
v
v
a
j
j
j
j
j
j
j
j
j
j
j
j
a
v
v
v
v
v
a
j
j
j
j
j
j
v
v
v
v
v
v
v
a
"}
(4,1,1) = {"
a
v
v
c
v
v
v
v
j
j
j
j
j
j
v
v
v
v
v
v
v
j
j
j
j
j
j
j
j
j
j
j
j
v
v
v
v
v
v
v
j
j
j
j
j
j
v
v
v
v
c
v
v
a
"}
(5,1,1) = {"
a
v
v
v
v
v
v
v
j
j
j
j
j
j
v
v
v
v
v
v
v
j
j
j
j
j
j
j
j
j
j
j
j
v
v
v
v
v
v
v
j
j
j
j
j
j
v
v
v
v
v
v
v
a
"}
(6,1,1) = {"
a
v
v
v
v
v
v
v
j
j
j
j
j
j
v
v
v
v
v
v
v
j
j
j
j
j
j
j
j
j
j
j
j
v
v
v
v
v
v
v
j
j
j
j
j
j
v
v
v
v
v
v
v
a
"}
(7,1,1) = {"
a
v
v
v
v
v
v
a
j
j
j
j
j
j
a
v
v
v
v
v
a
j
j
j
j
j
j
j
j
j
j
j
j
a
v
v
v
v
v
a
j
j
j
j
j
j
a
v
v
v
v
v
v
a
"}
(8,1,1) = {"
a
v
v
v
v
v
v
a
j
j
j
j
j
j
a
a
v
a
a
a
a
a
a
a
a
a
v
v
a
a
a
a
a
a
v
a
a
a
a
a
j
j
j
j
j
j
a
v
v
v
v
v
v
a
"}
(9,1,1) = {"
a
v
v
v
v
v
v
a
j
j
j
j
j
j
j
a
D
v
v
v
a
s
s
s
s
s
s
s
s
s
s
s
s
a
v
v
v
G
a
j
j
j
j
j
j
j
a
v
v
v
v
v
v
a
"}
(10,1,1) = {"
a
a
a
b
b
b
a
a
a
j
j
j
j
j
j
a
v
v
v
v
a
s
s
s
s
s
s
s
s
s
s
s
s
a
v
v
v
v
a
j
j
j
j
j
j
a
a
a
b
b
b
a
a
a
"}
(11,1,1) = {"
a
Q
Q
Q
Q
Q
Q
Q
a
j
j
j
j
j
j
a
v
v
v
v
a
s
s
s
s
s
s
s
s
s
s
s
s
a
v
v
v
v
a
j
j
j
j
j
j
a
O
O
O
O
O
O
O
a
"}
(12,1,1) = {"
a
Q
H
H
H
H
H
Q
a
a
a
v
v
a
a
a
v
v
v
v
a
s
s
s
s
s
s
s
s
s
s
s
s
a
v
v
v
v
a
a
a
v
v
a
a
a
O
f
f
f
f
f
O
a
"}
(13,1,1) = {"
B
Q
H
H
H
H
H
Q
b
v
v
v
v
v
v
v
v
v
v
v
v
s
s
s
s
s
v
v
s
s
s
s
s
v
e
w
W
v
v
v
v
v
v
v
v
b
O
f
f
f
f
f
O
B
"}
(14,1,1) = {"
P
Q
H
H
A
H
H
Q
b
v
v
v
v
v
v
v
v
c
v
v
v
s
s
s
s
s
c
v
s
s
s
s
s
v
w
K
q
v
v
v
v
v
v
v
v
b
O
f
f
z
f
f
O
P
"}
(15,1,1) = {"
C
Q
H
H
H
H
H
Q
b
v
v
v
v
v
v
v
v
v
v
v
v
s
s
s
s
s
v
v
s
s
s
s
s
v
r
w
o
v
v
v
v
v
v
v
v
b
O
f
f
f
f
f
O
C
"}
(16,1,1) = {"
a
Q
H
H
H
H
H
Q
a
a
a
v
v
a
a
a
v
v
v
v
a
s
s
s
s
s
s
s
s
s
s
s
s
a
v
v
v
v
a
a
a
v
v
a
a
a
O
f
f
f
f
f
O
a
"}
(17,1,1) = {"
a
Q
Q
Q
Q
Q
Q
Q
a
j
j
j
j
j
j
a
v
v
v
v
a
s
s
s
s
s
s
s
s
s
s
s
s
a
v
v
v
v
a
j
j
j
j
j
j
a
O
O
O
O
O
O
O
a
"}
(18,1,1) = {"
a
a
a
b
b
b
a
a
a
j
j
j
j
j
j
a
v
v
v
v
a
s
s
s
s
s
s
s
s
s
s
s
s
a
v
v
v
v
a
j
j
j
j
j
j
a
a
a
b
b
b
a
a
a
"}
(19,1,1) = {"
a
v
v
v
v
v
v
a
j
j
j
j
j
j
j
a
G
v
v
v
a
s
s
s
s
s
s
s
s
s
s
s
s
a
v
v
v
D
a
j
j
j
j
j
j
j
a
v
v
v
v
v
v
a
"}
(20,1,1) = {"
a
v
v
v
v
v
v
a
j
j
j
j
j
j
a
a
a
a
a
v
a
a
a
a
a
a
v
v
a
a
a
a
a
a
a
a
a
v
a
a
j
j
j
j
j
j
a
v
v
v
v
v
v
a
"}
(21,1,1) = {"
a
v
v
v
v
v
v
a
j
j
j
j
j
j
a
v
v
v
v
v
a
j
j
j
j
j
j
j
j
j
j
j
j
a
v
v
v
v
v
a
j
j
j
j
j
j
a
v
v
v
v
v
v
a
"}
(22,1,1) = {"
a
v
v
v
v
v
v
v
j
j
j
j
j
j
v
v
v
v
v
v
v
j
j
j
j
j
j
j
j
j
j
j
j
v
v
v
v
v
v
v
j
j
j
j
j
j
v
v
v
v
v
v
v
a
"}
(23,1,1) = {"
a
v
v
v
v
v
v
v
j
j
j
j
j
j
v
v
v
v
v
v
v
j
j
j
j
j
j
j
j
j
j
j
j
v
v
v
v
v
v
v
j
j
j
j
j
j
v
v
v
v
v
v
v
a
"}
(24,1,1) = {"
a
v
v
c
v
v
v
v
j
j
j
j
j
j
v
v
v
v
v
v
v
j
j
j
j
j
j
j
j
j
j
j
j
v
v
v
v
v
v
v
j
j
j
j
j
j
v
v
v
v
c
v
v
a
"}
(25,1,1) = {"
a
v
v
v
v
v
v
v
j
j
j
j
j
j
a
v
v
v
v
v
a
j
j
j
j
j
j
j
j
j
j
j
j
a
v
v
v
v
v
a
j
j
j
j
j
j
v
v
v
v
v
v
v
a
"}
(26,1,1) = {"
a
v
v
v
v
v
v
a
j
j
j
j
j
j
a
a
a
a
a
a
a
a
a
a
a
a
a
a
a
a
a
a
a
a
a
a
a
a
a
a
j
j
j
j
j
j
a
v
v
v
v
v
v
a
"}
(27,1,1) = {"
a
a
a
a
a
a
a
a
a
a
a
a
a
a
a
g
g
g
g
g
g
g
g
g
g
g
g
g
g
g
g
g
g
g
g
g
g
g
g
a
a
a
a
a
a
a
a
a
a
a
a
a
a
a
"}
