//MAP CONVERTED BY dmm2tgm.py THIS HEADER COMMENT PREVENTS RECONVERSION, DO NOT REMOVE
"a" = (
/turf/open/floor/plating/is12/rock,
/area/violence)
"b" = (
/obj/effect/turf_decal/is12,
/turf/open/floor/plating/is12/rock,
/area/violence)
"d" = (
/obj/effect/turf_decal/is12{
	icon_state = "l1"
	},
/turf/open/floor/plating/is12/dirt,
/area/violence)
"e" = (
/obj/effect/turf_decal/is12{
	icon_state = "m3"
	},
/turf/open/floor/plating/is12/dirt,
/area/violence)
"f" = (
/obj/effect/turf_decal/box/red/corners{
	dir = 1
	},
/turf/open/floor/plating/is12/wwidirtplating,
/area/violence)
"g" = (
/obj/effect/turf_decal/is12{
	icon_state = "dirtcornercenter"
	},
/turf/open/floor/plating/is12/trenchcenter,
/area/violence)
"h" = (
/obj/effect/turf_decal/is12{
	icon_state = "crater"
	},
/turf/open/floor/plating/is12/wwidirtplating,
/area/violence)
"i" = (
/obj/structure/emergency_shield/barrier,
/turf/open/floor/plating/is12/rock,
/area/violence)
"j" = (
/obj/effect/landmark/start/combatant/blue,
/turf/open/floor/plating/is12/trenchcenter,
/area/violence)
"k" = (
/obj/effect/turf_decal/is12{
	icon_state = "l5"
	},
/turf/open/floor/plating/is12/dirt,
/area/violence)
"l" = (
/obj/structure/rospilovo/bochka/fire,
/turf/open/floor/plating/is12/dirt,
/area/violence)
"m" = (
/obj/effect/turf_decal/is12{
	icon_state = "l4"
	},
/turf/open/floor/plating/is12/dirt,
/area/violence)
"n" = (
/obj/effect/turf_decal/is12{
	icon_state = "l3"
	},
/turf/open/floor/plating/is12/dirt,
/area/violence)
"o" = (
/turf/open/floor/plating/is12/wwidirtplating,
/area/violence)
"p" = (
/obj/effect/turf_decal/is12{
	icon_state = "m1"
	},
/turf/open/floor/plating/is12/dirt,
/area/violence)
"q" = (
/obj/effect/turf_decal/is12{
	icon_state = "l7"
	},
/turf/open/floor/plating/is12/dirt,
/area/violence)
"r" = (
/obj/effect/baseturf_helper/dune,
/turf/closed/mineral,
/area/violence)
"s" = (
/obj/effect/turf_decal/is12{
	icon_state = "crater"
	},
/turf/open/floor/plating/is12/dirt,
/area/violence)
"t" = (
/obj/effect/turf_decal/is12{
	icon_state = "l6"
	},
/turf/open/floor/plating/is12/dirt,
/area/violence)
"u" = (
/obj/structure/rospilovo/doski/doski4,
/turf/open/floor/plating/is12/rock,
/area/violence)
"v" = (
/obj/effect/turf_decal/is12{
	icon_state = "l2"
	},
/turf/open/floor/plating/is12/dirt,
/area/violence)
"w" = (
/obj/effect/turf_decal/box/red/corners,
/turf/open/floor/plating/is12/wwidirtplating,
/area/violence)
"x" = (
/turf/closed/mineral,
/area/violence)
"y" = (
/obj/structure/rospilovo/bochka,
/turf/open/floor/plating/is12/rock,
/area/violence)
"z" = (
/obj/effect/turf_decal/box/red,
/obj/effect/landmark/bomb_plant_location,
/turf/open/floor/plating/is12/wwidirtplating,
/area/violence)
"A" = (
/obj/structure/rospilovo/bochka,
/turf/open/floor/plating/is12/wwidirtplating,
/area/violence)
"B" = (
/obj/structure/rospilovo/doski/doski3,
/turf/open/floor/plating/is12/wwidirtplating,
/area/violence)
"C" = (
/obj/structure/rospilovo/bochka/fire,
/turf/open/floor/plating/is12/rock,
/area/violence)
"D" = (
/obj/structure/emergency_shield/barrier,
/turf/open/floor/plating/is12/dirt,
/area/violence)
"E" = (
/obj/structure/rospilovo/bochka,
/turf/open/floor/plating/is12/dirt,
/area/violence)
"F" = (
/obj/effect/turf_decal/box/red/corners{
	dir = 4
	},
/turf/open/floor/plating/is12/wwidirtplating,
/area/violence)
"G" = (
/obj/structure/rospilovo/doski,
/turf/open/floor/plating/is12/dirt,
/area/violence)
"H" = (
/obj/effect/turf_decal/is12{
	icon_state = "l8"
	},
/turf/open/floor/plating/is12/dirt,
/area/violence)
"I" = (
/obj/effect/turf_decal/is12{
	icon_state = "m4"
	},
/turf/open/floor/plating/is12/dirt,
/area/violence)
"J" = (
/obj/effect/landmark/start/combatant/red,
/turf/open/floor/plating/is12/rock,
/area/violence)
"K" = (
/obj/effect/turf_decal/box/red/corners{
	dir = 8
	},
/turf/open/floor/plating/is12/wwidirtplating,
/area/violence)
"L" = (
/turf/open/floor/plating/is12/trenchcenter,
/area/violence)
"M" = (
/obj/effect/turf_decal/is12{
	icon_state = "grass"
	},
/turf/open/floor/plating/is12/rock,
/area/violence)
"N" = (
/obj/effect/turf_decal/is12{
	icon_state = "l9"
	},
/turf/open/floor/plating/is12/dirt,
/area/violence)
"O" = (
/obj/effect/landmark/start/combatant/red,
/turf/open/floor/plating/is12/dirt,
/area/violence)
"P" = (
/obj/effect/turf_decal/is12{
	icon_state = "dirtcornerleft"
	},
/turf/open/floor/plating/is12/trenchcenter,
/area/violence)
"R" = (
/obj/effect/turf_decal/is12{
	icon_state = "dirtcornerright"
	},
/turf/open/floor/plating/is12/trenchcenter,
/area/violence)
"S" = (
/obj/structure/rospilovo/doski/doski2,
/turf/open/floor/plating/is12/dirt,
/area/violence)
"T" = (
/obj/effect/landmark/start/combatant/red,
/turf/open/floor/plating/is12/wwidirtplating,
/area/violence)
"U" = (
/obj/effect/turf_decal/is12{
	icon_state = "grass"
	},
/turf/open/floor/plating/is12/dirt,
/area/violence)
"V" = (
/obj/structure/rospilovo/bochka/fire,
/turf/open/floor/plating/is12/wwidirtplating,
/area/violence)
"W" = (
/obj/item/flashlight/flare/torch,
/obj/item/flashlight/flare/torch{
	pixel_x = -7;
	pixel_y = -1
	},
/obj/item/flashlight/flare/torch{
	pixel_x = 5;
	pixel_y = 3
	},
/turf/open/floor/plating/is12/trenchcenter,
/area/violence)
"X" = (
/obj/effect/turf_decal/is12{
	icon_state = "m2"
	},
/turf/open/floor/plating/is12/dirt,
/area/violence)
"Y" = (
/obj/structure/emergency_shield/barrier,
/turf/open/floor/plating/is12/wwidirtplating,
/area/violence)
"Z" = (
/turf/open/floor/plating/is12/dirt,
/area/violence)

(1,1,1) = {"
r
x
x
x
x
x
x
x
x
x
x
x
x
x
x
x
x
x
x
x
x
x
x
x
x
x
x
x
x
x
x
x
x
x
x
x
x
x
x
x
x
x
x
x
x
x
x
x
x
x
"}
(2,1,1) = {"
x
J
O
Y
Y
Y
a
a
a
a
a
a
a
a
a
o
o
o
o
o
o
o
Z
a
Z
Z
Z
Z
l
Z
E
a
Z
a
Z
Z
Z
C
Z
o
a
a
Y
V
o
o
L
L
L
x
"}
(3,1,1) = {"
x
J
T
D
Y
i
Z
a
a
a
a
a
a
a
o
o
o
h
o
Z
Z
o
Z
Z
Z
Z
a
Z
Z
a
y
a
a
Z
I
e
a
a
Z
Z
a
o
Y
o
o
j
W
j
L
x
"}
(4,1,1) = {"
x
T
T
Y
D
D
a
a
a
a
M
a
a
a
o
o
B
o
o
o
o
a
Z
Z
Z
a
Z
Z
Z
Z
Z
Z
Z
Z
X
p
Z
Z
o
a
o
o
Y
o
o
j
W
j
L
x
"}
(5,1,1) = {"
x
T
O
Y
D
i
a
a
a
a
a
a
a
a
o
o
o
o
o
o
E
Z
a
Z
Z
Z
E
Z
q
H
d
Z
G
U
Z
Z
a
Z
a
Z
o
a
Y
o
o
j
W
j
L
x
"}
(6,1,1) = {"
x
O
T
D
i
i
a
a
a
a
a
a
o
o
o
o
o
o
o
a
Z
Z
Z
Z
Z
Z
Z
U
t
N
v
Z
Z
Z
Z
a
a
o
w
o
F
o
Y
o
a
j
W
j
L
x
"}
(7,1,1) = {"
x
T
O
i
i
i
a
a
a
b
a
a
o
a
o
o
a
o
o
Z
s
Z
Z
a
Z
Z
Z
Z
k
m
n
U
Z
a
a
o
o
o
o
z
o
o
Y
a
a
j
W
j
P
x
"}
(8,1,1) = {"
x
T
O
i
i
i
a
a
a
o
o
o
A
o
U
o
o
o
Z
Z
S
Z
Z
Z
U
Z
Z
Z
Z
Z
Z
Z
Z
o
u
a
a
o
K
o
f
o
Y
Z
a
j
W
j
g
x
"}
(9,1,1) = {"
x
J
O
i
i
i
a
a
o
a
o
o
V
o
o
o
o
a
Z
Z
a
Z
a
Z
l
Z
E
y
Z
Z
E
o
o
Z
a
a
o
V
o
o
o
o
Y
C
a
L
L
L
R
x
"}
(10,1,1) = {"
x
x
x
x
x
x
x
x
x
x
x
x
x
x
x
x
x
x
x
x
x
x
x
x
x
x
x
x
x
x
x
x
x
x
x
x
x
x
x
x
x
x
x
x
x
x
x
x
x
x
"}
