//MAP CONVERTED BY dmm2tgm.py THIS HEADER COMMENT PREVENTS RECONVERSION, DO NOT REMOVE
"a" = (
/obj/effect/baseturf_helper/dune,
/turf/closed/indestructible/black,
/area/violence)
"b" = (
/turf/closed/indestructible/reinforced,
/area/violence)
"c" = (
/obj/effect/landmark/stationroom/maintenance/rdm3x3,
/turf/open/floor/plastic,
/area/violence)
"e" = (
/obj/effect/landmark/bomb_plant_location,
/obj/effect/turf_decal/box/red,
/obj/item/gun/ballistic/automatic/pistol/malorian{
	pixel_x = 5;
	pixel_y = 13
	},
/turf/open/floor/plasteel/vaporwave,
/area/violence)
"f" = (
/turf/closed/indestructible/black,
/area/violence)
"g" = (
/turf/open/floor/plasteel/chapel,
/area/violence)
"h" = (
/turf/open/floor/plasteel/chapel{
	dir = 4
	},
/area/violence)
"i" = (
/obj/structure/table,
/turf/open/floor/resin,
/area/violence)
"k" = (
/obj/structure/emergency_shield/barrier,
/turf/open/floor/plasteel/catwalk_floor,
/area/violence)
"m" = (
/turf/open/floor/plastic,
/area/violence)
"o" = (
/obj/effect/landmark/stationroom/maintenance/rdm3x3,
/turf/open/floor/resin/crypto,
/area/violence)
"p" = (
/turf/open/floor/plasteel/sepia,
/area/violence)
"q" = (
/obj/effect/turf_decal/box/red/corners,
/turf/open/floor/plasteel/vaporwave,
/area/violence)
"r" = (
/turf/open/floor/plasteel/white,
/area/violence)
"s" = (
/obj/effect/turf_decal/box/red/corners{
	dir = 1
	},
/turf/open/floor/plasteel/vaporwave,
/area/violence)
"t" = (
/turf/closed/wall,
/area/violence)
"u" = (
/turf/open/floor/plasteel/bluespace,
/area/violence)
"v" = (
/obj/effect/turf_decal/box/red/corners{
	dir = 4
	},
/turf/open/floor/plasteel/vaporwave,
/area/violence)
"y" = (
/turf/open/floor/plasteel/dark,
/area/violence)
"A" = (
/turf/open/floor/resin/crypto,
/area/violence)
"B" = (
/turf/open/floor/resin,
/area/violence)
"C" = (
/obj/structure/table,
/turf/open/floor/plasteel/white,
/area/violence)
"D" = (
/turf/open/floor/plasteel/cafeteria,
/area/violence)
"E" = (
/obj/effect/landmark/start/combatant/red,
/obj/effect/turf_decal/tile/red{
	dir = 4
	},
/obj/effect/turf_decal/tile/red{
	dir = 8
	},
/obj/effect/turf_decal/tile/red{
	dir = 1
	},
/obj/effect/turf_decal/tile/red,
/turf/open/floor/plasteel/dark,
/area/violence)
"G" = (
/obj/effect/turf_decal/box/red,
/obj/effect/landmark/bomb_plant_location,
/turf/open/floor/plasteel/vaporwave,
/area/violence)
"H" = (
/turf/open/floor/plasteel/grimy,
/area/violence)
"I" = (
/obj/effect/landmark/stationroom/maintenance/rdm3x3,
/turf/open/floor/plasteel/dark,
/area/violence)
"J" = (
/obj/effect/landmark/stationroom/maintenance/rdm10x10,
/turf/open/floor/plasteel/bluespace,
/area/violence)
"L" = (
/turf/open/floor/stone,
/area/violence)
"M" = (
/turf/open/floor/plasteel/chapel{
	dir = 1
	},
/area/violence)
"N" = (
/turf/open/floor/plasteel/monofloor/dark,
/area/violence)
"O" = (
/turf/open/floor/plasteel/chapel{
	dir = 8
	},
/area/violence)
"P" = (
/obj/machinery/door/airlock/grunge,
/turf/open/floor/plasteel/catwalk_floor,
/area/violence)
"R" = (
/turf/open/floor/plasteel/vaporwave,
/area/violence)
"T" = (
/turf/open/floor/plasteel/durasteel,
/area/violence)
"U" = (
/turf/open/floor/plasteel/cult,
/area/violence)
"W" = (
/obj/effect/landmark/start/combatant/blue,
/obj/effect/turf_decal/tile/blue,
/obj/effect/turf_decal/tile/blue{
	dir = 8
	},
/obj/effect/turf_decal/tile/blue{
	dir = 1
	},
/obj/effect/turf_decal/tile/blue{
	dir = 4
	},
/turf/open/floor/plasteel/dark,
/area/violence)
"Y" = (
/obj/effect/turf_decal/box/red/corners{
	dir = 8
	},
/turf/open/floor/plasteel/vaporwave,
/area/violence)

(1,1,1) = {"
a
f
f
f
f
f
f
f
f
f
f
f
f
f
f
f
f
f
f
f
f
f
f
f
f
f
f
f
f
f
f
f
f
f
f
f
f
f
f
f
f
f
f
f
f
f
f
f
f
f
"}
(2,1,1) = {"
f
t
t
t
t
t
t
t
t
t
t
t
t
t
t
t
t
t
t
t
t
t
t
t
t
t
t
t
t
t
t
t
t
t
t
t
t
t
t
t
t
f
t
t
t
t
t
t
t
f
"}
(3,1,1) = {"
f
t
u
u
u
u
u
u
u
u
u
J
t
U
U
U
U
U
t
L
L
L
L
L
P
y
y
y
t
r
r
r
r
r
t
H
H
H
H
H
t
f
t
E
E
E
E
E
t
f
"}
(4,1,1) = {"
f
t
u
u
u
u
u
u
u
u
u
u
t
U
U
U
U
U
t
L
L
L
L
L
t
y
y
y
P
r
r
r
r
r
t
H
H
H
H
H
t
b
t
E
E
E
E
E
t
f
"}
(5,1,1) = {"
f
t
u
u
u
u
u
u
u
u
u
u
P
U
U
U
U
U
P
L
L
L
L
L
t
t
t
t
t
r
r
C
r
r
P
H
H
H
H
H
k
k
k
E
E
E
E
E
t
f
"}
(6,1,1) = {"
f
t
u
u
u
u
u
u
u
u
u
u
t
U
U
U
U
U
t
L
L
L
L
L
t
y
y
I
t
r
r
C
r
r
t
H
H
H
H
H
t
b
t
E
E
E
E
E
t
f
"}
(7,1,1) = {"
f
t
u
u
u
u
u
u
u
u
u
u
t
U
U
U
U
U
t
L
L
L
L
L
P
y
y
y
P
r
r
C
r
r
t
H
H
H
H
H
t
f
t
E
E
E
E
E
t
f
"}
(8,1,1) = {"
f
t
u
u
u
u
u
u
u
u
u
u
t
t
t
P
t
t
t
t
t
t
t
t
t
y
y
y
t
r
r
C
r
r
t
t
t
P
t
t
t
f
t
t
t
k
t
t
t
f
"}
(9,1,1) = {"
f
t
u
u
u
u
u
u
u
u
u
u
t
T
T
T
T
T
t
g
M
N
O
h
t
t
t
t
t
r
r
C
r
r
t
D
D
D
D
D
t
f
f
f
b
k
b
f
f
f
"}
(10,1,1) = {"
f
t
u
u
u
u
u
u
u
u
u
u
t
T
T
T
T
T
t
M
g
N
h
O
t
y
y
I
t
r
r
C
r
r
t
D
D
D
D
D
t
t
t
t
t
k
t
t
t
f
"}
(11,1,1) = {"
f
t
u
u
u
u
u
u
u
u
u
u
t
T
T
T
T
T
P
N
N
N
N
N
P
y
y
y
P
r
r
C
r
r
t
D
D
D
D
D
D
D
t
H
H
H
H
H
t
f
"}
(12,1,1) = {"
f
t
u
u
u
u
u
u
u
u
u
u
t
T
T
T
T
T
t
h
O
N
M
g
t
y
y
y
t
r
r
C
r
r
t
D
D
D
D
D
D
D
t
H
H
H
H
H
t
f
"}
(13,1,1) = {"
f
t
t
t
P
t
t
t
t
t
t
t
t
t
T
T
T
T
t
O
h
N
g
M
t
t
t
t
t
r
r
C
r
r
P
D
D
D
D
D
D
D
P
H
H
H
H
H
t
f
"}
(14,1,1) = {"
f
t
U
U
U
U
U
t
T
T
T
T
t
t
t
P
t
t
t
t
P
t
t
t
t
A
A
o
t
r
r
r
r
r
t
D
D
D
D
D
D
D
t
H
H
H
H
H
t
f
"}
(15,1,1) = {"
f
t
U
U
U
U
U
t
T
T
T
T
T
t
B
B
B
B
B
B
B
t
p
p
P
A
A
A
P
r
r
r
r
r
t
D
D
D
D
D
D
D
t
H
H
H
H
H
t
f
"}
(16,1,1) = {"
f
t
U
U
U
U
U
P
T
T
T
T
T
P
B
B
B
B
B
B
B
P
p
p
t
A
A
A
t
t
t
P
t
t
t
t
t
P
t
t
t
t
t
t
t
P
t
t
t
f
"}
(17,1,1) = {"
f
t
U
U
U
U
U
t
T
T
T
T
T
t
B
B
B
B
B
B
B
t
t
t
t
t
t
t
t
B
B
B
B
B
t
r
r
r
r
r
r
r
r
r
r
r
r
r
t
f
"}
(18,1,1) = {"
f
t
U
U
U
U
U
t
T
T
T
T
T
t
B
B
B
i
B
B
B
t
m
m
c
m
m
c
t
B
B
B
B
B
t
r
r
r
r
r
r
r
r
r
r
r
r
r
t
f
"}
(19,1,1) = {"
f
t
t
t
P
t
t
t
t
t
P
t
t
t
B
B
B
B
B
B
B
P
m
m
m
m
m
m
P
B
B
i
B
B
P
r
r
C
C
C
C
C
C
C
C
C
r
r
t
f
"}
(20,1,1) = {"
f
t
L
L
L
L
L
t
g
M
N
O
h
t
B
B
B
B
B
B
B
t
m
m
m
m
m
m
t
B
B
B
B
B
t
r
r
r
r
r
r
r
r
r
r
r
r
r
t
f
"}
(21,1,1) = {"
f
t
L
L
L
L
L
t
M
g
N
h
O
P
B
B
B
B
B
B
B
t
t
t
P
P
t
t
t
B
B
B
B
B
t
r
r
r
r
r
r
r
r
r
r
r
r
r
t
f
"}
(22,1,1) = {"
f
t
L
L
L
L
L
P
N
N
N
N
N
t
t
P
t
t
P
t
t
t
R
R
R
R
R
R
t
t
t
P
t
t
t
P
t
t
t
P
t
t
t
P
t
t
P
t
t
f
"}
(23,1,1) = {"
f
t
L
L
L
L
L
t
h
O
N
M
g
t
p
p
t
m
m
c
t
R
R
R
R
R
R
R
R
t
m
m
c
t
A
A
o
t
y
y
I
t
y
y
I
t
y
y
t
f
"}
(24,1,1) = {"
f
t
L
L
L
L
L
t
O
h
N
g
M
t
p
p
t
m
m
m
t
R
R
q
q
v
v
R
R
t
m
m
m
t
A
A
A
t
y
y
y
t
y
y
y
t
y
y
t
f
"}
(25,1,1) = {"
f
t
P
t
t
t
P
t
t
t
P
t
t
t
P
t
t
m
m
m
P
R
R
q
G
e
v
R
R
P
m
m
m
t
A
A
A
t
y
y
y
t
y
y
y
t
y
y
t
f
"}
(26,1,1) = {"
f
t
y
y
t
y
y
I
t
y
y
I
t
A
A
o
t
m
m
c
P
R
R
Y
G
G
s
R
R
P
m
m
c
t
t
P
t
t
t
P
t
t
t
P
t
t
t
P
t
f
"}
(27,1,1) = {"
f
t
y
y
t
y
y
y
t
y
y
y
t
A
A
A
t
m
m
m
t
R
R
Y
Y
s
s
R
R
t
m
m
m
t
p
p
t
g
M
N
O
h
t
L
L
L
L
L
t
f
"}
(28,1,1) = {"
f
t
y
y
t
y
y
y
t
y
y
y
t
A
A
A
t
m
m
m
t
R
R
R
R
R
R
R
R
t
m
m
m
t
p
p
t
M
g
N
h
O
t
L
L
L
L
L
t
f
"}
(29,1,1) = {"
f
t
t
P
t
t
P
t
t
t
P
t
t
t
P
t
t
t
P
t
t
t
R
R
R
R
R
R
t
t
t
P
t
t
P
t
t
N
N
N
N
N
P
L
L
L
L
L
t
f
"}
(30,1,1) = {"
f
t
r
r
r
r
r
r
r
r
r
r
r
r
r
t
B
B
B
B
B
t
t
t
P
P
t
t
t
B
B
B
B
B
B
B
P
h
O
N
M
g
t
L
L
L
L
L
t
f
"}
(31,1,1) = {"
f
t
r
r
r
r
r
r
r
r
r
r
r
r
r
t
B
B
B
B
B
t
m
m
c
m
m
c
t
B
B
B
B
B
B
B
t
O
h
N
g
M
t
L
L
L
L
L
t
f
"}
(32,1,1) = {"
f
t
r
r
C
C
C
C
C
C
C
C
C
r
r
P
B
B
i
B
B
P
m
m
m
m
m
m
P
B
B
B
B
B
B
B
t
t
t
P
t
t
t
t
t
P
t
t
t
f
"}
(33,1,1) = {"
f
t
r
r
r
r
r
r
r
r
r
r
r
r
r
t
B
B
B
B
B
t
m
m
m
m
m
m
t
B
B
B
i
B
B
B
t
T
T
T
T
T
t
U
U
U
U
U
t
f
"}
(34,1,1) = {"
f
t
r
r
r
r
r
r
r
r
r
r
r
r
r
t
B
B
B
B
B
t
t
t
t
t
t
t
t
B
B
B
B
B
B
B
t
T
T
T
T
T
t
U
U
U
U
U
t
f
"}
(35,1,1) = {"
f
t
t
t
P
t
t
t
t
t
t
t
P
t
t
t
t
t
P
t
t
t
A
A
o
t
p
p
P
B
B
B
B
B
B
B
P
T
T
T
T
T
P
U
U
U
U
U
t
f
"}
(36,1,1) = {"
f
t
H
H
H
H
H
t
D
D
D
D
D
D
D
t
r
r
r
r
r
P
A
A
A
P
p
p
t
B
B
B
B
B
B
B
t
T
T
T
T
T
t
U
U
U
U
U
t
f
"}
(37,1,1) = {"
f
t
H
H
H
H
H
t
D
D
D
D
D
D
D
t
r
r
r
r
r
t
A
A
A
t
t
t
t
P
t
t
t
t
P
t
t
t
T
T
T
T
t
U
U
U
U
U
t
f
"}
(38,1,1) = {"
f
t
H
H
H
H
H
P
D
D
D
D
D
D
D
P
r
r
C
r
r
t
t
t
t
t
g
M
N
O
h
t
T
T
T
T
t
t
t
P
t
t
t
t
t
P
t
t
t
f
"}
(39,1,1) = {"
f
t
H
H
H
H
H
t
D
D
D
D
D
D
D
t
r
r
C
r
r
t
y
y
I
t
M
g
N
h
O
t
T
T
T
T
T
t
u
u
u
u
u
u
u
u
u
J
t
f
"}
(40,1,1) = {"
f
t
H
H
H
H
H
t
D
D
D
D
D
D
D
t
r
r
C
r
r
P
y
y
y
P
N
N
N
N
N
P
T
T
T
T
T
P
u
u
u
u
u
u
u
u
u
u
t
f
"}
(41,1,1) = {"
f
t
t
t
k
t
t
t
t
t
D
D
D
D
D
t
r
r
C
r
r
t
y
y
y
t
h
O
N
M
g
t
T
T
T
T
T
t
u
u
u
u
u
u
u
u
u
u
t
f
"}
(42,1,1) = {"
f
f
f
b
k
b
f
f
f
t
D
D
D
D
D
t
r
r
C
r
r
t
t
t
t
t
O
h
N
g
M
t
T
T
T
T
T
t
u
u
u
u
u
u
u
u
u
u
t
f
"}
(43,1,1) = {"
f
t
t
t
k
t
t
t
f
t
t
t
P
t
t
t
r
r
C
r
r
t
y
y
I
t
t
t
P
t
t
t
t
t
P
t
t
t
u
u
u
u
u
u
u
u
u
u
t
f
"}
(44,1,1) = {"
f
t
W
W
W
W
W
t
f
t
H
H
H
H
H
t
r
r
C
r
r
P
y
y
y
P
L
L
L
L
L
t
U
U
U
U
U
t
u
u
u
u
u
u
u
u
u
u
t
f
"}
(45,1,1) = {"
f
t
W
W
W
W
W
t
b
t
H
H
H
H
H
t
r
r
C
r
r
t
y
y
y
t
L
L
L
L
L
t
U
U
U
U
U
t
u
u
u
u
u
u
u
u
u
u
t
f
"}
(46,1,1) = {"
f
t
W
W
W
W
W
k
k
k
H
H
H
H
H
P
r
r
C
r
r
t
t
t
t
t
L
L
L
L
L
P
U
U
U
U
U
P
u
u
u
u
u
u
u
u
u
u
t
f
"}
(47,1,1) = {"
f
t
W
W
W
W
W
t
b
t
H
H
H
H
H
t
r
r
r
r
r
P
y
y
y
t
L
L
L
L
L
t
U
U
U
U
U
t
u
u
u
u
u
u
u
u
u
u
t
f
"}
(48,1,1) = {"
f
t
W
W
W
W
W
t
f
t
H
H
H
H
H
t
r
r
r
r
r
t
y
y
y
P
L
L
L
L
L
t
U
U
U
U
U
t
u
u
u
u
u
u
u
u
u
u
t
f
"}
(49,1,1) = {"
f
t
t
t
t
t
t
t
f
t
t
t
t
t
t
t
t
t
t
t
t
t
t
t
t
t
t
t
t
t
t
t
t
t
t
t
t
t
t
t
t
t
t
t
t
t
t
t
t
f
"}
(50,1,1) = {"
f
f
f
f
f
f
f
f
f
f
f
f
f
f
f
f
f
f
f
f
f
f
f
f
f
f
f
f
f
f
f
f
f
f
f
f
f
f
f
f
f
f
f
f
f
f
f
f
f
f
"}
