//MAP CONVERTED BY dmm2tgm.py THIS HEADER COMMENT PREVENTS RECONVERSION, DO NOT REMOVE
"aO" = (
/obj/effect/landmark/start/combatant/blue,
/obj/effect/particle_cyberspess,
/turf/open/floor/dz/normal,
/area/violence)
"cC" = (
/obj/effect/mapping_helpers/turf_rotation,
/obj/effect/particle_cyberspess,
/turf/open/floor/dz/hot_plates,
/area/violence)
"cM" = (
/obj/structure/madman_computer,
/turf/open/floor/dz/cyber,
/area/violence)
"dr" = (
/obj/effect/turf_decal/box/red/corners{
	dir = 1
	},
/turf/open/floor/dz/green,
/area/violence)
"dG" = (
/obj/effect/powerup/health,
/turf/open/floor/dz/normal,
/area/violence)
"jk" = (
/obj/effect/turf_decal/box/red/corners,
/turf/open/floor/dz/green,
/area/violence)
"jo" = (
/obj/structure/sign/dz/end,
/turf/closed/dz/normal/cyber,
/area/violence)
"jD" = (
/obj/structure/emergency_shield/barrier,
/turf/open/floor/dz/normal,
/area/violence)
"mp" = (
/obj/effect/baseturf_helper/dune,
/turf/closed/dz/normal/cyber,
/area/violence)
"oE" = (
/obj/effect/landmark/bomb_plant_location,
/obj/effect/turf_decal/box/red,
/obj/effect/particle_cyberspess,
/turf/open/floor/dz/trippy_green,
/area/violence)
"sq" = (
/obj/effect/landmark/start/combatant/red,
/turf/open/floor/dz/normal,
/area/violence)
"sR" = (
/obj/structure/sign/dz,
/turf/closed/dz/normal/cyber,
/area/violence)
"xw" = (
/turf/open/floor/dz/cyber,
/area/violence)
"zU" = (
/obj/effect/mapping_helpers/turf_rotation,
/turf/open/floor/dz/hot_plates,
/area/violence)
"CQ" = (
/turf/closed/dz/normal/cyber,
/area/violence)
"Hy" = (
/obj/effect/powerup/health/full,
/turf/open/floor/dz/green,
/area/violence)
"IU" = (
/obj/effect/turf_decal/box/red/corners{
	dir = 4
	},
/turf/open/floor/dz/green,
/area/violence)
"Js" = (
/obj/effect/powerup/ammo,
/turf/open/floor/dz/normal,
/area/violence)
"JA" = (
/obj/structure/sign/poster/random,
/turf/closed/dz/normal/cyber,
/area/violence)
"JJ" = (
/obj/effect/landmark/start/combatant/red,
/obj/effect/particle_cyberspess,
/turf/open/floor/dz/normal,
/area/violence)
"Kt" = (
/turf/open/floor/dz/normal,
/area/violence)
"Li" = (
/obj/effect/landmark/start/combatant/blue,
/turf/open/floor/dz/normal,
/area/violence)
"Lr" = (
/obj/effect/particle_cyberspess,
/turf/open/floor/dz/normal,
/area/violence)
"Nb" = (
/obj/effect/turf_decal/box/red/corners{
	dir = 8
	},
/turf/open/floor/dz/green,
/area/violence)
"UD" = (
/obj/effect/particle_cyberspess,
/turf/open/floor/dz/cyber,
/area/violence)
"VO" = (
/obj/structure/sign/dz/middle,
/turf/closed/dz/normal/cyber,
/area/violence)
"ZH" = (
/turf/open/floor/dz/green,
/area/violence)

(1,1,1) = {"
mp
CQ
CQ
CQ
CQ
CQ
CQ
CQ
CQ
CQ
CQ
CQ
CQ
CQ
CQ
CQ
CQ
CQ
CQ
CQ
CQ
CQ
CQ
CQ
CQ
CQ
CQ
CQ
CQ
CQ
CQ
CQ
CQ
CQ
CQ
CQ
CQ
CQ
CQ
"}
(2,1,1) = {"
CQ
xw
xw
xw
xw
xw
xw
xw
xw
xw
xw
xw
xw
xw
xw
xw
xw
xw
xw
xw
xw
xw
xw
xw
xw
xw
xw
xw
xw
xw
xw
xw
xw
xw
xw
xw
xw
xw
CQ
"}
(3,1,1) = {"
CQ
xw
xw
xw
xw
xw
xw
xw
xw
xw
xw
xw
xw
xw
xw
xw
xw
xw
xw
xw
xw
xw
xw
xw
xw
xw
xw
xw
xw
xw
xw
xw
xw
xw
xw
xw
xw
xw
CQ
"}
(4,1,1) = {"
CQ
xw
xw
xw
xw
xw
xw
xw
xw
xw
xw
xw
xw
xw
xw
xw
xw
xw
xw
xw
xw
xw
xw
xw
xw
xw
xw
xw
xw
xw
xw
xw
xw
xw
xw
xw
xw
xw
CQ
"}
(5,1,1) = {"
CQ
xw
xw
xw
xw
xw
xw
xw
UD
xw
xw
xw
xw
xw
xw
xw
UD
xw
xw
xw
xw
xw
cC
xw
xw
xw
xw
xw
xw
xw
UD
xw
xw
xw
xw
xw
xw
xw
CQ
"}
(6,1,1) = {"
CQ
xw
xw
xw
xw
xw
xw
xw
xw
xw
xw
xw
xw
xw
xw
xw
xw
xw
xw
xw
xw
xw
xw
xw
xw
xw
xw
xw
xw
xw
xw
xw
xw
xw
xw
xw
xw
xw
CQ
"}
(7,1,1) = {"
CQ
xw
xw
xw
xw
xw
xw
xw
xw
xw
xw
xw
xw
xw
xw
xw
xw
xw
xw
xw
xw
xw
xw
xw
xw
xw
xw
xw
xw
xw
xw
xw
xw
xw
xw
xw
xw
xw
CQ
"}
(8,1,1) = {"
CQ
xw
xw
xw
xw
xw
xw
xw
xw
xw
xw
xw
xw
xw
xw
xw
xw
xw
xw
xw
xw
xw
xw
xw
xw
xw
xw
xw
xw
xw
xw
xw
xw
xw
xw
xw
xw
xw
CQ
"}
(9,1,1) = {"
CQ
xw
xw
xw
xw
xw
xw
xw
xw
xw
xw
xw
xw
xw
xw
xw
xw
xw
xw
xw
xw
xw
xw
xw
xw
xw
xw
xw
xw
xw
xw
xw
xw
xw
xw
xw
xw
xw
CQ
"}
(10,1,1) = {"
CQ
xw
xw
xw
xw
xw
xw
xw
xw
xw
xw
xw
xw
zU
zU
zU
xw
zU
zU
zU
zU
zU
xw
zU
zU
zU
xw
xw
xw
xw
xw
xw
xw
xw
xw
xw
xw
xw
CQ
"}
(11,1,1) = {"
CQ
xw
xw
xw
xw
xw
xw
xw
xw
xw
xw
xw
xw
zU
zU
zU
xw
zU
zU
zU
zU
zU
xw
zU
zU
zU
xw
xw
xw
xw
xw
xw
xw
xw
xw
xw
xw
xw
CQ
"}
(12,1,1) = {"
CQ
xw
xw
xw
xw
xw
xw
xw
xw
xw
xw
xw
xw
zU
zU
zU
xw
zU
zU
zU
zU
zU
xw
zU
zU
zU
xw
xw
xw
xw
xw
xw
xw
xw
xw
xw
xw
xw
CQ
"}
(13,1,1) = {"
CQ
CQ
jD
jD
jD
CQ
CQ
CQ
CQ
CQ
CQ
xw
xw
xw
xw
xw
xw
zU
zU
zU
zU
zU
xw
xw
xw
xw
xw
xw
CQ
CQ
CQ
CQ
CQ
CQ
jD
jD
jD
CQ
CQ
"}
(14,1,1) = {"
CQ
sq
sq
sq
sq
sq
CQ
Kt
Kt
dG
CQ
xw
zU
zU
xw
xw
xw
CQ
JA
CQ
JA
CQ
xw
xw
xw
zU
zU
xw
CQ
Js
Kt
Kt
CQ
Li
Li
Li
Li
Li
CQ
"}
(15,1,1) = {"
sR
sq
sq
sq
sq
sq
jD
Kt
Kt
Kt
Kt
xw
zU
zU
xw
xw
xw
xw
jk
ZH
IU
xw
xw
xw
xw
zU
zU
xw
Kt
Kt
Kt
Kt
jD
Li
Li
Li
Li
Li
sR
"}
(16,1,1) = {"
VO
sq
sq
JJ
sq
sq
jD
Kt
Lr
Kt
Kt
xw
xw
xw
xw
xw
UD
xw
Hy
oE
Hy
xw
UD
xw
xw
xw
xw
xw
Kt
Kt
Lr
Kt
jD
Li
Li
aO
Li
Li
VO
"}
(17,1,1) = {"
jo
sq
sq
sq
sq
sq
jD
Kt
Kt
Kt
Kt
xw
zU
zU
xw
xw
xw
xw
Nb
ZH
dr
xw
xw
xw
xw
zU
zU
xw
Kt
Kt
Kt
Kt
jD
Li
Li
Li
Li
Li
jo
"}
(18,1,1) = {"
CQ
sq
sq
sq
sq
sq
CQ
Kt
Kt
Js
CQ
xw
zU
zU
xw
xw
xw
CQ
JA
CQ
JA
CQ
xw
xw
xw
zU
zU
xw
CQ
dG
Kt
Kt
CQ
Li
Li
Li
Li
Li
CQ
"}
(19,1,1) = {"
CQ
CQ
jD
jD
jD
CQ
CQ
CQ
CQ
CQ
CQ
xw
xw
xw
xw
xw
xw
zU
zU
zU
zU
zU
xw
xw
xw
xw
xw
xw
CQ
CQ
CQ
CQ
CQ
CQ
jD
jD
jD
CQ
CQ
"}
(20,1,1) = {"
CQ
xw
xw
xw
xw
xw
xw
xw
xw
xw
xw
xw
xw
zU
zU
zU
xw
zU
zU
zU
zU
zU
xw
zU
zU
zU
xw
xw
xw
xw
xw
xw
xw
xw
xw
xw
xw
xw
CQ
"}
(21,1,1) = {"
CQ
xw
xw
xw
xw
xw
xw
xw
xw
xw
xw
xw
xw
zU
zU
zU
xw
zU
zU
zU
zU
zU
xw
zU
zU
zU
xw
xw
xw
xw
xw
xw
xw
xw
xw
xw
xw
xw
CQ
"}
(22,1,1) = {"
CQ
xw
xw
xw
xw
xw
xw
xw
xw
xw
xw
xw
xw
zU
zU
zU
xw
zU
zU
zU
zU
zU
xw
zU
zU
zU
xw
xw
xw
xw
xw
xw
xw
xw
xw
xw
xw
xw
CQ
"}
(23,1,1) = {"
CQ
xw
xw
xw
xw
xw
xw
xw
xw
xw
xw
xw
xw
xw
xw
xw
xw
xw
xw
xw
xw
xw
xw
xw
xw
xw
xw
xw
xw
xw
xw
xw
xw
xw
xw
xw
xw
xw
CQ
"}
(24,1,1) = {"
CQ
xw
xw
xw
xw
xw
xw
xw
xw
xw
xw
xw
xw
xw
xw
xw
xw
xw
xw
xw
xw
xw
xw
xw
xw
xw
xw
xw
xw
xw
xw
xw
xw
xw
xw
xw
xw
xw
CQ
"}
(25,1,1) = {"
CQ
xw
xw
xw
xw
xw
xw
xw
xw
xw
xw
xw
xw
xw
xw
xw
xw
xw
xw
xw
xw
xw
xw
xw
xw
xw
xw
xw
xw
xw
xw
xw
xw
xw
xw
xw
xw
xw
CQ
"}
(26,1,1) = {"
CQ
xw
xw
xw
xw
xw
xw
xw
xw
xw
xw
xw
xw
xw
xw
xw
xw
xw
xw
xw
xw
xw
xw
xw
xw
xw
xw
xw
xw
xw
xw
xw
xw
xw
xw
xw
xw
xw
CQ
"}
(27,1,1) = {"
CQ
xw
xw
xw
xw
xw
xw
xw
UD
xw
xw
xw
xw
xw
xw
xw
UD
xw
xw
xw
xw
xw
UD
xw
xw
xw
xw
xw
xw
xw
UD
xw
xw
xw
xw
xw
xw
xw
CQ
"}
(28,1,1) = {"
CQ
xw
xw
xw
xw
xw
xw
xw
xw
xw
xw
xw
xw
xw
xw
xw
xw
xw
xw
xw
xw
xw
xw
xw
xw
xw
xw
xw
xw
xw
xw
xw
xw
xw
xw
xw
xw
xw
CQ
"}
(29,1,1) = {"
CQ
xw
xw
xw
xw
xw
xw
xw
xw
xw
xw
xw
xw
xw
xw
xw
xw
xw
xw
xw
xw
xw
xw
xw
xw
xw
xw
xw
xw
xw
xw
xw
xw
xw
xw
xw
xw
xw
CQ
"}
(30,1,1) = {"
CQ
cM
xw
xw
xw
xw
xw
xw
xw
xw
xw
xw
xw
xw
xw
xw
xw
xw
xw
xw
xw
xw
xw
xw
xw
xw
xw
xw
xw
xw
xw
xw
xw
xw
xw
xw
xw
xw
CQ
"}
(31,1,1) = {"
CQ
CQ
CQ
CQ
CQ
CQ
CQ
CQ
CQ
CQ
CQ
CQ
CQ
CQ
CQ
CQ
CQ
CQ
CQ
CQ
CQ
CQ
CQ
CQ
CQ
CQ
CQ
CQ
CQ
CQ
CQ
CQ
CQ
CQ
CQ
CQ
CQ
CQ
CQ
"}
