//MAP CONVERTED BY dmm2tgm.py THIS HEADER COMMENT PREVENTS RECONVERSION, DO NOT REMOVE
"ad" = (
/obj/structure/bonfire/prelit,
/turf/open/floor/plating/is12/rock,
/area/violence)
"aQ" = (
/obj/item/flashlight/flare/torch{
	pixel_x = -7;
	pixel_y = -1
	},
/obj/item/flashlight/flare/torch{
	pixel_x = 5;
	pixel_y = 3
	},
/obj/item/flashlight/flare/torch,
/turf/open/floor/plating/is12/trenchcenter,
/area/violence)
"aS" = (
/obj/machinery/light/dim/directional/north,
/turf/open/floor/plating/is12/wwidirt,
/area/violence)
"bl" = (
/obj/structure/deployable_barricade/sandbags{
	dir = 4
	},
/turf/open/floor/plating/is12/wwidirtplating,
/area/violence)
"by" = (
/turf/open/floor/plating/is12/dirt,
/area/violence)
"bS" = (
/obj/machinery/light/dim/directional/north,
/turf/open/floor/plating/is12/dirt,
/area/violence)
"cf" = (
/obj/structure/rospilovo/water/bochka,
/obj/machinery/light/dim/directional/south,
/turf/open/floor/plating/is12/trenchcenter,
/area/violence)
"cj" = (
/obj/structure/rospilovo/bochka/red,
/turf/open/floor/plating/is12/trenchcenter,
/area/violence)
"dn" = (
/obj/effect/turf_decal/box/red/corners{
	dir = 8
	},
/turf/open/floor/plating/is12/trenchcenter,
/area/violence)
"dT" = (
/obj/effect/turf_decal/box/red/corners{
	dir = 1
	},
/turf/open/floor/plating/is12/trenchcenter,
/area/violence)
"ex" = (
/obj/structure/rospilovo/doski/doski4,
/turf/open/floor/plating/is12/rock,
/area/violence)
"fo" = (
/obj/machinery/light/dim/directional/west,
/turf/open/floor/plating/is12/rock,
/area/violence)
"fO" = (
/obj/structure/rospilovo/doski/doski2,
/turf/open/floor/plating/is12/wwidirtplating,
/area/violence)
"gn" = (
/obj/structure/closet/crate/miningcar,
/obj/effect/turf_decal/is12{
	icon_state = "dirtcornerleft"
	},
/turf/open/floor/plating/is12/trenchcenter,
/area/violence)
"gP" = (
/obj/item/pickaxe/rusted,
/obj/effect/turf_decal/is12{
	icon_state = "dirtcornercenter"
	},
/turf/open/floor/plating/is12/trenchcenter,
/area/violence)
"gX" = (
/obj/structure/rospilovo/bochka,
/turf/open/floor/plating/is12/trenchcenter,
/area/violence)
"hx" = (
/obj/machinery/light/dim/directional/east,
/turf/open/floor/plating/is12/dirt,
/area/violence)
"hy" = (
/obj/structure/deployable_barricade/sandbags,
/turf/open/floor/plating/is12/wwidirt,
/area/violence)
"iS" = (
/obj/structure/rospilovo/doski/doski3,
/turf/open/floor/plating/is12/rock,
/area/violence)
"jX" = (
/obj/effect/turf_decal/is12{
	icon_state = "grass"
	},
/turf/open/floor/plating/is12/dirt,
/area/violence)
"kt" = (
/obj/machinery/light/dim/directional/west,
/turf/open/floor/plating/is12/dirt,
/area/violence)
"kW" = (
/obj/structure/rospilovo/doski/doski3,
/turf/open/floor/plating/is12/trenchcenter,
/area/violence)
"nG" = (
/obj/effect/turf_decal/is12{
	icon_state = "dirtcornercenter"
	},
/turf/open/floor/plating/is12/dirt,
/area/violence)
"nO" = (
/obj/item/flashlight/flare/torch{
	pixel_x = -7;
	pixel_y = -1
	},
/obj/item/flashlight/flare/torch{
	pixel_x = 5;
	pixel_y = 3
	},
/obj/item/flashlight/flare/torch,
/turf/open/floor/plating/is12/wwidirt,
/area/violence)
"nU" = (
/turf/open/floor/plating/is12/wood,
/area/violence)
"os" = (
/obj/structure/rospilovo/doski/doski2,
/turf/open/floor/plating/is12/rock,
/area/violence)
"oM" = (
/obj/structure/rospilovo/doski/doski4,
/turf/open/floor/plating/is12/trenchcenter,
/area/violence)
"ps" = (
/obj/structure/deployable_barricade/sandbags,
/turf/open/floor/plating/is12/dirt,
/area/violence)
"pE" = (
/turf/closed/indestructible/black,
/area/violence)
"pO" = (
/obj/machinery/light/dim/directional/south,
/turf/open/floor/plating/is12/trenchcenter,
/area/violence)
"pV" = (
/obj/structure/rospilovo/bochka,
/obj/machinery/light/dim/directional/south,
/turf/open/floor/plating/is12/trenchcenter,
/area/violence)
"pX" = (
/obj/structure/rospilovo/bochka/red,
/turf/open/floor/plating/is12/wwidirtplating,
/area/violence)
"qZ" = (
/turf/open/floor/plating/is12/mud,
/area/violence)
"rh" = (
/obj/structure/emergency_shield/barrier,
/turf/open/floor/plating/is12/dirt,
/area/violence)
"rp" = (
/obj/effect/turf_decal/is12{
	icon_state = "dirtcornerleft"
	},
/turf/open/floor/plating/is12/rock,
/area/violence)
"rR" = (
/obj/effect/turf_decal/is12{
	icon_state = "dirtcornerleft"
	},
/turf/open/floor/plating/is12/dirt,
/area/violence)
"sg" = (
/obj/machinery/light/dim/directional/south,
/turf/open/floor/plating/is12/dirt,
/area/violence)
"sp" = (
/obj/structure/rospilovo/doski/doski2,
/turf/open/floor/plating/is12/wwidirt,
/area/violence)
"sK" = (
/obj/effect/turf_decal/is12{
	icon_state = "grass"
	},
/turf/open/floor/plating/is12/rock,
/area/violence)
"sZ" = (
/obj/structure/closet/crate/miningcar,
/turf/open/floor/plating/is12/rock,
/area/violence)
"td" = (
/obj/structure/deployable_barricade/sandbags{
	dir = 4
	},
/turf/open/floor/plating/is12/dirt,
/area/violence)
"tV" = (
/obj/item/flashlight/flare/torch,
/turf/open/floor/plating/is12/dirt,
/area/violence)
"ur" = (
/obj/structure/rospilovo/doski,
/turf/open/floor/plating/is12/trenchcenter,
/area/violence)
"uy" = (
/turf/open/floor/plating/is12/trenchcenter,
/area/violence)
"uA" = (
/obj/machinery/light/dim/directional/north,
/turf/open/floor/plating/is12/rock,
/area/violence)
"vl" = (
/obj/effect/turf_decal/is12{
	icon_state = "dirtcornercenter"
	},
/turf/open/floor/plating/is12/rock,
/area/violence)
"wH" = (
/obj/structure/rospilovo/bochka/fire,
/turf/open/floor/plating/is12/wwidirt,
/area/violence)
"xz" = (
/obj/structure/deployable_barricade/sandbags{
	dir = 8
	},
/turf/open/floor/plating/is12/dirt,
/area/violence)
"yw" = (
/turf/open/floor/plating/is12/wwidirtplating,
/area/violence)
"ze" = (
/obj/machinery/light/dim/directional/north,
/turf/open/floor/plating/is12/trenchcenter,
/area/violence)
"zK" = (
/turf/closed/indestructible/riveted/dirtystone,
/area/violence)
"Ai" = (
/obj/structure/rospilovo/bochka/red,
/obj/effect/turf_decal/is12{
	icon_state = "dirtcornerright"
	},
/turf/open/floor/plating/is12/trenchcenter,
/area/violence)
"Au" = (
/obj/structure/rospilovo/doski/doski2,
/turf/open/floor/plating/is12/dirt,
/area/violence)
"AU" = (
/obj/effect/landmark/start/combatant/red,
/turf/open/floor/plating/is12/trenchcenter,
/area/violence)
"AX" = (
/obj/effect/turf_decal/box/red/corners{
	dir = 4
	},
/turf/open/floor/plating/is12/trenchcenter,
/area/violence)
"Ba" = (
/obj/item/flashlight/flare/torch,
/turf/open/floor/plating/is12/trenchcenter,
/area/violence)
"Be" = (
/obj/structure/emergency_shield/barrier,
/turf/open/floor/plating/is12/wwidirt,
/area/violence)
"Ch" = (
/obj/structure/bonfire/prelit,
/turf/open/floor/plating/is12/wwidirtplating,
/area/violence)
"Ck" = (
/obj/effect/landmark/start/combatant/blue,
/turf/open/floor/plating/is12/trenchcenter,
/area/violence)
"Cx" = (
/turf/open/floor/plating/is12/wwidirt,
/area/violence)
"CB" = (
/obj/structure/rospilovo/bochka,
/obj/effect/turf_decal/is12{
	icon_state = "dirtcornerright"
	},
/turf/open/floor/plating/is12/trenchcenter,
/area/violence)
"CW" = (
/obj/effect/turf_decal/box/red,
/obj/effect/landmark/bomb_plant_location,
/turf/open/floor/plating/is12/trenchcenter,
/area/violence)
"Dc" = (
/obj/structure/rospilovo/bochka,
/obj/machinery/light/dim/directional/south,
/turf/open/floor/plating/is12/wood,
/area/violence)
"DV" = (
/obj/structure/rospilovo/bochka/fire,
/turf/open/floor/plating/is12/dirt,
/area/violence)
"EF" = (
/obj/structure/rospilovo/doski,
/turf/open/floor/plating/is12/wwidirtplating,
/area/violence)
"Gj" = (
/obj/machinery/light/dim/directional/east,
/turf/open/floor/plating/is12/trenchcenter,
/area/violence)
"GH" = (
/obj/effect/baseturf_helper/dune,
/turf/closed/indestructible/black,
/area/violence)
"Ka" = (
/obj/structure/rospilovo/doski,
/turf/open/floor/plating/is12/rock,
/area/violence)
"KL" = (
/obj/machinery/light/dim/directional/south,
/turf/open/floor/plating/is12/wwidirt,
/area/violence)
"Mz" = (
/turf/open/floor/plating/is12/surface,
/area/violence)
"MH" = (
/turf/open/floor/plating/is12/rock,
/area/violence)
"MJ" = (
/obj/item/toy/katana,
/turf/open/floor/plating/is12/dirt,
/area/violence)
"Ny" = (
/obj/structure/rospilovo/doski/doski4,
/turf/open/floor/plating/is12/wwidirt,
/area/violence)
"ND" = (
/turf/closed/mineral/ash_rock,
/area/violence)
"Of" = (
/obj/structure/rospilovo/water/bochka,
/turf/open/floor/plating/is12/trenchcenter,
/area/violence)
"OF" = (
/obj/structure/closet/crate/miningcar,
/turf/open/floor/plating/is12/trenchcenter,
/area/violence)
"PT" = (
/obj/structure/rospilovo/bochka/fire,
/turf/open/floor/plating/is12/trenchcenter,
/area/violence)
"Tr" = (
/obj/structure/rospilovo/bochka/fire,
/turf/open/floor/plating/is12/rock,
/area/violence)
"TV" = (
/obj/item/pickaxe/rusted,
/turf/open/floor/plating/is12/trenchcenter,
/area/violence)
"VH" = (
/obj/structure/rospilovo/bochka/red,
/turf/open/floor/plating/is12/wood,
/area/violence)
"VJ" = (
/obj/effect/light_emitter,
/turf/open/floor/plating/is12/surface,
/area/violence)
"Xe" = (
/obj/machinery/light/dim/directional/north,
/turf/open/floor/plating/is12/wwidirtplating,
/area/violence)
"Xf" = (
/obj/structure/rospilovo/bochka/fire,
/turf/open/floor/plating/is12/wwidirtplating,
/area/violence)
"XF" = (
/obj/item/flashlight/flare/torch{
	pixel_x = -7;
	pixel_y = -1
	},
/obj/item/flashlight/flare/torch{
	pixel_x = 5;
	pixel_y = 3
	},
/obj/item/flashlight/flare/torch,
/turf/open/floor/plating/is12/dirt,
/area/violence)
"Yp" = (
/obj/item/flashlight/flare/torch,
/turf/open/floor/plating/is12/wwidirt,
/area/violence)
"Yx" = (
/obj/structure/rospilovo/doski/doski4,
/turf/open/floor/plating/is12/wwidirtplating,
/area/violence)
"ZF" = (
/obj/effect/turf_decal/box/red/corners,
/turf/open/floor/plating/is12/trenchcenter,
/area/violence)
"ZL" = (
/obj/item/pickaxe/rusted,
/obj/effect/turf_decal/is12{
	icon_state = "dirtcornerleft"
	},
/turf/open/floor/plating/is12/trenchcenter,
/area/violence)

(1,1,1) = {"
GH
pE
pE
pE
zK
zK
zK
zK
zK
zK
zK
zK
zK
pE
pE
pE
pE
zK
zK
zK
zK
zK
zK
zK
zK
zK
zK
zK
zK
pE
pE
pE
pE
zK
zK
zK
zK
zK
zK
zK
zK
zK
zK
zK
zK
zK
zK
zK
zK
zK
"}
(2,1,1) = {"
pE
zK
zK
zK
zK
ND
ND
ND
zK
zK
kt
by
zK
zK
zK
zK
zK
zK
ND
zK
zK
ND
ND
ND
ND
ND
ND
ND
zK
zK
zK
zK
pE
zK
TV
TV
TV
gX
gX
CB
zK
DV
zK
zK
Ck
Ck
Ck
Ck
Ck
zK
"}
(3,1,1) = {"
zK
zK
by
by
by
by
ND
ND
ND
by
MJ
by
by
ND
ND
by
by
ND
ND
ND
ND
ND
ND
ND
zK
zK
zK
ND
ND
ND
ND
zK
zK
zK
uy
uy
uy
uy
uy
uy
zK
XF
zK
zK
Ck
Ck
Ck
Ck
Ck
zK
"}
(4,1,1) = {"
zK
by
by
zK
zK
by
ND
ND
ND
by
by
by
ND
ND
zK
zK
by
by
yw
yw
yw
yw
yw
ND
by
by
ND
ND
ND
ND
ND
yw
yw
uy
uy
uy
zK
zK
uy
uy
uy
tV
by
rh
Ck
Ck
PT
Ck
Ck
zK
"}
(5,1,1) = {"
zK
by
zK
zK
zK
by
zK
zK
ND
ND
ND
ND
ND
ND
zK
ND
ND
by
by
yw
yw
yw
yw
yw
yw
by
ND
ND
ND
ND
ND
yw
yw
Xf
uy
uy
uy
uy
uy
pO
zK
tV
zK
zK
Ck
Ck
Ck
Ck
Ck
zK
"}
(6,1,1) = {"
zK
by
by
zK
zK
by
zK
zK
zK
zK
ND
ND
ND
ND
zK
ND
ND
ND
by
ND
ND
zK
zK
yw
yw
yw
by
ND
zK
MH
MH
yw
yw
yw
yw
yw
uy
OF
OF
gn
zK
by
zK
zK
Ck
Ck
Ck
Ck
Ck
zK
"}
(7,1,1) = {"
zK
zK
by
by
yw
yw
yw
yw
zK
zK
zK
ND
zK
zK
zK
zK
zK
zK
ND
zK
zK
zK
zK
yw
zK
zK
zK
by
zK
uA
MH
MH
yw
EF
zK
zK
zK
zK
zK
zK
zK
by
ND
zK
zK
zK
rh
zK
zK
zK
"}
(8,1,1) = {"
zK
zK
zK
yw
yw
yw
Xf
yw
by
by
by
yw
by
by
yw
yw
yw
yw
yw
yw
yw
yw
yw
yw
zK
yw
zK
by
zK
MH
MH
MH
MH
MH
yw
yw
yw
yw
yw
by
by
by
ND
ND
ND
zK
by
zK
pE
pE
"}
(9,1,1) = {"
zK
ND
ND
yw
yw
fO
uy
pO
zK
zK
zK
yw
zK
ND
zK
zK
zK
zK
yw
zK
zK
zK
zK
Yx
zK
yw
zK
by
ND
ND
zK
zK
zK
zK
zK
zK
by
zK
zK
zK
zK
by
ND
ND
ND
zK
by
zK
pE
pE
"}
(10,1,1) = {"
zK
ND
ND
ND
uy
uy
uy
uy
zK
zK
zK
yw
zK
zK
zK
yw
fO
yw
yw
nU
nU
nU
zK
yw
yw
yw
by
yw
yw
yw
yw
by
by
by
by
by
by
uy
uy
cj
zK
by
ND
ND
zK
zK
by
zK
pE
pE
"}
(11,1,1) = {"
zK
zK
ND
ND
ND
uy
uy
uy
ND
zK
zK
yw
yw
uy
uy
uy
yw
uy
uy
nU
nU
Dc
zK
by
zK
yw
zK
yw
yw
yw
ND
zK
zK
zK
jX
ZF
uy
AX
uy
pV
zK
by
ND
ND
by
tV
XF
zK
pE
pE
"}
(12,1,1) = {"
pE
zK
ND
ND
ND
uy
uy
uy
ND
ND
zK
yw
yw
uy
uy
uy
uy
uy
uy
nU
nU
VH
zK
by
zK
yw
zK
yw
yw
ND
ND
ND
MH
MH
uy
uy
CW
uy
uy
gX
zK
by
ND
ND
by
by
by
zK
pE
pE
"}
(13,1,1) = {"
pE
zK
ND
ND
by
zK
zK
uy
ND
ND
ND
yw
zK
ND
ND
yw
yw
uy
uy
nU
VH
VH
zK
by
zK
zK
zK
yw
ND
ND
ND
MH
MH
MH
uy
dn
uy
dT
uy
gX
zK
by
ND
zK
by
by
DV
zK
pE
pE
"}
(14,1,1) = {"
pE
zK
ND
zK
by
ND
zK
uy
ND
ND
ND
MH
zK
ND
ND
yw
zK
zK
zK
zK
zK
zK
zK
by
ND
ND
zK
yw
ND
ND
MH
MH
os
MH
zK
zK
zK
zK
zK
zK
zK
by
zK
zK
td
zK
zK
zK
zK
zK
"}
(15,1,1) = {"
zK
zK
ND
ND
by
ND
zK
MH
MH
ND
ND
MH
zK
ND
yw
yw
yw
yw
yw
by
by
by
by
by
by
ND
zK
yw
zK
ND
MH
MH
MH
MH
MH
MH
MH
ND
ND
ND
by
hx
by
by
by
by
by
by
by
zK
"}
(16,1,1) = {"
zK
ND
ND
by
by
ND
zK
MH
MH
ND
ND
MH
zK
zK
zK
zK
zK
zK
zK
by
by
ND
ND
ND
by
zK
zK
yw
zK
zK
zK
zK
MH
zK
MH
ND
ND
ND
ND
ND
zK
zK
zK
zK
zK
zK
zK
zK
Cx
zK
"}
(17,1,1) = {"
zK
ND
ND
by
by
ND
zK
MH
MH
uy
ND
MH
ND
ND
ND
ND
ND
kt
zK
ND
ND
ND
ND
yw
by
yw
by
by
by
by
by
by
by
by
Cx
ND
ND
ND
MH
MH
ex
MH
MH
ND
ND
ND
ND
zK
Cx
zK
"}
(18,1,1) = {"
zK
ND
ND
by
ND
zK
zK
MH
Ka
gX
zK
MH
ND
MH
MH
by
zK
by
zK
ND
ND
ND
zK
bl
zK
yw
zK
by
zK
zK
zK
zK
zK
zK
Cx
ND
ND
MH
MH
MH
MH
MH
MH
MH
MH
ND
ND
zK
Cx
zK
"}
(19,1,1) = {"
zK
ND
zK
by
ND
zK
uA
MH
uy
gX
zK
MH
MH
MH
MH
MH
zK
by
zK
ND
ND
ND
zK
yw
zK
yw
zK
by
zK
cj
cj
Of
uy
zK
Cx
ND
MH
MH
zK
Tr
zK
zK
MH
zK
Cx
Cx
ND
zK
KL
zK
"}
(20,1,1) = {"
zK
by
zK
by
zK
zK
uy
uy
uy
cj
zK
MH
ND
MH
MH
MH
zK
by
zK
qZ
kW
uy
zK
yw
zK
zK
zK
by
by
uy
oM
uy
uy
uy
Cx
ND
MH
MH
zK
zK
zK
ND
MH
zK
Cx
Cx
Cx
Cx
Cx
zK
"}
(21,1,1) = {"
zK
by
zK
by
by
by
uy
uy
uy
uy
zK
MH
zK
MH
MH
MH
zK
by
by
uy
uy
uy
zK
yw
yw
yw
zK
by
zK
ze
uy
uy
uy
zK
Cx
zK
MH
MH
MH
MH
iS
MH
rp
zK
Cx
Cx
Cx
zK
zK
zK
"}
(22,1,1) = {"
zK
by
zK
MH
zK
zK
MH
sK
uy
uy
zK
sg
zK
MH
MH
MH
zK
by
zK
yw
uy
uy
zK
yw
yw
pX
zK
by
zK
zK
zK
zK
zK
zK
Cx
zK
MH
MH
MH
MH
MH
MH
vl
zK
Cx
Cx
Cx
zK
ND
zK
"}
(23,1,1) = {"
zK
uA
zK
MH
ND
zK
MH
MH
MH
rp
zK
by
ND
MH
MH
MH
zK
by
zK
yw
yw
yw
zK
yw
zK
zK
zK
by
zK
zK
by
by
by
zK
aS
zK
zK
zK
zK
zK
MH
zK
zK
zK
zK
ND
Cx
ND
ND
zK
"}
(24,1,1) = {"
zK
MH
MH
MH
ND
zK
MH
MH
MH
vl
zK
by
zK
ND
by
by
zK
by
zK
yw
Ch
yw
zK
EF
zK
zK
MH
MH
MH
zK
by
ND
ND
zK
Cx
Cx
Cx
Cx
Cx
Cx
Cx
Cx
Cx
Cx
Cx
Cx
Cx
ND
ND
zK
"}
(25,1,1) = {"
zK
MH
MH
MH
MH
zK
zK
MH
MH
zK
zK
by
by
ND
ND
ND
by
MH
zK
yw
yw
yw
zK
MH
MH
MH
MH
ad
MH
MH
MH
by
ND
ND
ND
zK
zK
zK
zK
zK
Cx
zK
zK
zK
zK
zK
ND
ND
ND
zK
"}
(26,1,1) = {"
zK
MH
ND
ND
MH
by
zK
ND
ND
ND
zK
by
by
by
zK
ND
MH
MH
ND
zK
zK
zK
zK
MH
ND
ND
MH
MH
MH
zK
ND
by
ND
zK
yw
zK
yw
yw
yw
Cx
Cx
MH
fo
MH
MH
MH
ND
ND
ND
zK
"}
(27,1,1) = {"
zK
MH
ND
ND
ND
by
ND
ND
ND
zK
by
by
by
by
by
MH
MH
MH
MH
MH
fo
MH
MH
iS
MH
ND
ND
zK
zK
zK
ND
by
ND
zK
yw
zK
EF
yw
ND
ND
MH
MH
sK
MH
MH
MH
ND
ND
zK
zK
"}
(28,1,1) = {"
zK
MH
ND
ND
ND
by
ND
ND
ND
zK
zK
ND
zK
zK
zK
MH
MH
MH
MH
MH
MH
MH
MH
MH
MH
MH
ND
ND
ND
zK
zK
by
zK
zK
zK
zK
yw
ND
ND
ND
zK
zK
zK
zK
MH
zK
zK
zK
zK
pE
"}
(29,1,1) = {"
zK
MH
ND
ND
ND
by
ND
ND
ND
zK
zK
ND
zK
ND
ND
ND
MH
MH
MH
Mz
MH
MH
MH
MH
MH
MH
MH
MH
MH
fo
MH
MH
by
by
by
by
yw
ND
ND
ND
by
ND
ND
by
MH
MH
MH
zK
pE
pE
"}
(30,1,1) = {"
zK
by
by
ND
ND
by
by
by
by
by
by
by
zK
ND
ND
ND
MH
ND
qZ
Mz
Mz
MH
MH
MH
zK
zK
zK
MH
zK
zK
zK
by
zK
zK
zK
zK
yw
nU
VH
zK
by
ND
ND
zK
zK
zK
MH
zK
pE
pE
"}
(31,1,1) = {"
zK
zK
by
by
zK
zK
zK
yw
zK
zK
zK
by
by
by
ND
MH
MH
ND
qZ
Mz
Mz
Mz
MH
MH
MH
zK
cj
uy
MH
ND
zK
by
by
ND
ND
zK
by
nU
VH
zK
bS
ND
ND
ND
ND
zK
MH
zK
pE
pE
"}
(32,1,1) = {"
zK
zK
zK
by
zK
zK
Xe
yw
uy
cj
zK
zK
ND
ND
ND
MH
MH
ND
ND
Mz
VJ
Mz
MH
MH
MH
zK
gX
uy
MH
MH
zK
zK
yw
ND
ND
zK
ze
nU
VH
zK
by
by
ND
ND
ND
ND
MH
zK
pE
pE
"}
(33,1,1) = {"
zK
ND
ND
by
ND
ND
yw
Yx
uy
gX
zK
zK
ND
zK
ND
by
MH
by
ps
Mz
Mz
Mz
Mz
MH
MH
zK
uy
sK
MH
MH
rR
zK
yw
ND
ND
zK
by
zK
zK
zK
by
by
by
by
by
by
by
zK
zK
pE
"}
(34,1,1) = {"
zK
ND
ND
by
ND
ND
ND
yw
yw
uy
zK
zK
ND
zK
ND
ND
by
by
by
ND
Mz
Mz
Mz
MH
MH
zK
uy
MH
MH
MH
nG
zK
yw
zK
zK
by
by
by
by
by
by
by
ND
ND
by
ND
ND
ND
zK
pE
"}
(35,1,1) = {"
zK
ND
ND
by
ND
ND
ND
zK
zK
uy
zK
zK
ND
zK
zK
by
by
by
by
ND
ND
Mz
by
by
by
zK
Gj
MH
MH
by
zK
zK
yw
zK
zK
zK
zK
zK
by
zK
ND
by
zK
ND
by
zK
zK
zK
zK
pE
"}
(36,1,1) = {"
zK
ND
ND
by
by
by
by
by
by
by
by
by
by
by
by
MH
MH
by
by
by
by
by
by
Au
ND
zK
zK
by
zK
zK
zK
yw
yw
yw
zK
DV
by
by
MH
zK
ND
by
zK
ND
MH
ND
ND
zK
zK
pE
"}
(37,1,1) = {"
zK
zK
zK
by
zK
zK
zK
zK
zK
zK
zK
by
zK
zK
MH
MH
MH
MH
zK
zK
zK
zK
zK
by
zK
zK
zK
by
zK
zK
zK
yw
zK
zK
zK
by
by
MH
MH
zK
ND
by
zK
MH
MH
ND
ND
ND
zK
pE
"}
(38,1,1) = {"
pE
zK
MH
MH
MH
sZ
OF
OF
cj
cj
zK
by
zK
ND
ND
by
ex
MH
zK
by
kt
by
by
by
by
by
by
by
by
by
by
yw
ND
ND
zK
by
sK
MH
MH
zK
ND
by
zK
MH
MH
MH
ND
ND
zK
pE
"}
(39,1,1) = {"
pE
zK
MH
MH
MH
uy
aQ
uy
uy
cf
zK
bS
zK
ND
ND
ND
ND
by
zK
by
by
DV
zK
by
zK
zK
zK
zK
zK
zK
zK
by
by
ND
zK
MH
MH
MH
MH
zK
ND
by
MH
MH
MH
MH
ND
ND
zK
zK
"}
(40,1,1) = {"
pE
zK
MH
Tr
MH
uy
Ba
Ba
uy
gX
zK
by
zK
ND
by
ND
zK
xz
zK
by
by
zK
zK
by
zK
yw
yw
yw
uy
cj
zK
by
by
by
by
MH
MH
by
by
zK
by
ND
Cx
Cx
MH
MH
MH
ND
ND
zK
"}
(41,1,1) = {"
pE
zK
MH
MH
uy
uy
uy
uy
uy
gX
zK
by
zK
by
by
ND
zK
by
zK
by
by
zK
by
by
zK
yw
yw
yw
EF
yw
zK
by
ND
ND
zK
zK
zK
by
zK
zK
Cx
Cx
Cx
Cx
MH
MH
MH
MH
ND
zK
"}
(42,1,1) = {"
pE
zK
MH
MH
MH
MH
MH
ur
uy
ZL
zK
by
zK
by
by
ND
zK
by
zK
by
by
zK
MH
MH
yw
yw
zK
yw
yw
yw
zK
by
ND
ND
ND
ND
zK
Cx
Cx
Cx
Cx
Cx
ND
ND
ND
zK
zK
MH
by
zK
"}
(43,1,1) = {"
pE
zK
zK
MH
zK
zK
uA
uy
uy
gP
zK
by
zK
ND
by
ND
zK
bS
zK
by
uy
zK
MH
MH
sK
MH
zK
yw
yw
yw
zK
by
by
ND
zK
zK
zK
by
by
Ny
Cx
Cx
ND
ND
ND
MH
zK
zK
by
zK
"}
(44,1,1) = {"
zK
zK
zK
rh
zK
zK
zK
Cx
TV
Ai
zK
Cx
zK
ND
Cx
ND
zK
by
zK
ze
uy
zK
ND
ND
MH
MH
zK
zK
zK
zK
zK
ND
by
ND
zK
by
by
by
by
zK
Cx
zK
zK
MH
MH
MH
Tr
zK
by
zK
"}
(45,1,1) = {"
zK
AU
AU
AU
AU
AU
zK
Cx
zK
zK
zK
sp
zK
zK
Cx
zK
zK
by
zK
uy
uy
zK
ND
ND
MH
MH
MH
yw
yw
yw
zK
ND
by
ND
by
by
by
by
ND
zK
Cx
zK
Tr
MH
MH
MH
zK
zK
by
zK
"}
(46,1,1) = {"
zK
AU
AU
AU
AU
AU
zK
Cx
Cx
hy
Cx
Cx
Cx
Cx
Cx
Cx
Cx
by
zK
uy
cj
zK
ND
ND
ND
MH
MH
MH
yw
yw
zK
zK
ND
zK
by
by
by
zK
zK
zK
Cx
zK
zK
zK
MH
zK
zK
by
by
zK
"}
(47,1,1) = {"
zK
AU
AU
PT
AU
AU
zK
zK
zK
zK
Cx
zK
zK
zK
zK
zK
zK
zK
zK
uy
zK
zK
ND
ND
ND
by
by
by
zK
yw
by
zK
zK
zK
zK
by
zK
zK
ND
zK
by
zK
zK
bS
by
by
zK
by
ND
zK
"}
(48,1,1) = {"
zK
AU
AU
AU
AU
AU
zK
zK
Cx
Cx
Cx
Yp
wH
zK
zK
ND
ND
ND
ND
ND
by
by
ND
ND
zK
by
by
zK
zK
zK
by
by
by
zK
zK
by
ND
ND
ND
ND
by
by
by
by
ND
by
by
by
ND
zK
"}
(49,1,1) = {"
zK
AU
AU
AU
AU
AU
Be
Cx
Cx
Cx
Cx
nO
Cx
Cx
Cx
Cx
by
by
by
ND
zK
by
hx
by
by
by
zK
zK
pE
zK
bS
by
by
by
by
by
ND
ND
ND
zK
zK
ND
ND
ND
ND
ND
ND
ND
ND
zK
"}
(50,1,1) = {"
zK
zK
zK
zK
zK
zK
zK
zK
zK
zK
zK
zK
zK
zK
zK
zK
zK
zK
zK
zK
zK
zK
zK
zK
zK
zK
zK
pE
pE
zK
zK
zK
zK
zK
zK
zK
zK
zK
zK
zK
zK
zK
zK
zK
zK
zK
zK
zK
zK
zK
"}
