//MAP CONVERTED BY dmm2tgm.py THIS HEADER COMMENT PREVENTS RECONVERSION, DO NOT REMOVE
"a" = (
/turf/closed/indestructible/oldshuttle,
/area/violence)
"c" = (
/obj/effect/turf_decal/siding/white{
	dir = 8
	},
/turf/open/floor/plasteel/showroomfloor,
/area/violence)
"f" = (
/turf/open/floor/plasteel/showroomfloor,
/area/violence)
"g" = (
/turf/open/floor/plating/asteroid/basalt,
/area/violence)
"i" = (
/obj/effect/turf_decal/box/red/corners{
	dir = 4
	},
/turf/open/floor/plating/asteroid/basalt,
/area/violence)
"j" = (
/obj/effect/turf_decal/tile/blue,
/obj/effect/turf_decal/tile/blue{
	dir = 8
	},
/obj/effect/turf_decal/tile/blue{
	dir = 1
	},
/obj/effect/turf_decal/tile/blue{
	dir = 4
	},
/turf/open/floor/plasteel/showroomfloor,
/area/violence)
"k" = (
/obj/effect/landmark/bomb_plant_location,
/obj/effect/turf_decal/box/red,
/turf/open/floor/plating/asteroid/basalt,
/area/violence)
"m" = (
/obj/effect/turf_decal/pool{
	dir = 8
	},
/obj/effect/turf_decal/tile/blue,
/obj/effect/turf_decal/tile/blue{
	dir = 8
	},
/obj/effect/turf_decal/tile/blue{
	dir = 1
	},
/obj/effect/turf_decal/tile/blue{
	dir = 4
	},
/obj/structure/emergency_shield/barrier,
/turf/open/floor/plasteel/showroomfloor,
/area/violence)
"q" = (
/turf/closed/indestructible/oldshuttle/corner{
	dir = 1
	},
/area/violence)
"s" = (
/turf/open/lava/smooth,
/area/violence)
"v" = (
/obj/structure/rack,
/obj/item/oar,
/obj/item/oar,
/obj/item/oar,
/obj/item/oar,
/obj/item/oar,
/obj/item/oar,
/obj/item/oar,
/obj/item/oar,
/turf/open/floor/plasteel/showroomfloor,
/area/violence)
"w" = (
/obj/item/oar,
/obj/item/oar,
/obj/item/oar,
/obj/item/oar,
/obj/item/oar,
/obj/item/oar,
/obj/item/oar,
/obj/item/oar,
/obj/structure/rack,
/turf/open/floor/plasteel/showroomfloor,
/area/violence)
"y" = (
/obj/effect/turf_decal/box/red/corners,
/turf/open/floor/plating/asteroid/basalt,
/area/violence)
"z" = (
/obj/effect/landmark/start/combatant/blue,
/obj/effect/turf_decal/tile/blue,
/obj/effect/turf_decal/tile/blue{
	dir = 8
	},
/obj/effect/turf_decal/tile/blue{
	dir = 1
	},
/obj/effect/turf_decal/tile/blue{
	dir = 4
	},
/turf/open/floor/plasteel/showroomfloor,
/area/violence)
"B" = (
/obj/effect/turf_decal/tile/red,
/obj/effect/turf_decal/tile/red{
	dir = 1
	},
/obj/effect/turf_decal/tile/red{
	dir = 8
	},
/obj/effect/turf_decal/tile/red{
	dir = 4
	},
/turf/open/floor/plasteel/showroomfloor,
/area/violence)
"D" = (
/turf/closed/indestructible/oldshuttle/corner,
/area/violence)
"F" = (
/obj/effect/turf_decal/box/red/corners{
	dir = 1
	},
/turf/open/floor/plating/asteroid/basalt,
/area/violence)
"G" = (
/obj/item/stack/rods/lava/thirty,
/turf/open/floor/plating/asteroid/basalt,
/area/violence)
"I" = (
/obj/effect/turf_decal/siding/white{
	dir = 4
	},
/turf/open/floor/plasteel/showroomfloor,
/area/violence)
"J" = (
/obj/vehicle/ridden/lavaboat,
/turf/open/lava/smooth,
/area/violence)
"L" = (
/obj/effect/turf_decal/box/red/corners{
	dir = 8
	},
/turf/open/floor/plating/asteroid/basalt,
/area/violence)
"M" = (
/obj/effect/landmark/start/combatant/red,
/obj/effect/turf_decal/tile/red,
/obj/effect/turf_decal/tile/red{
	dir = 1
	},
/obj/effect/turf_decal/tile/red{
	dir = 8
	},
/obj/effect/turf_decal/tile/red{
	dir = 4
	},
/turf/open/floor/plasteel/showroomfloor,
/area/violence)
"N" = (
/turf/closed/indestructible/oldshuttle/corner{
	dir = 4
	},
/area/violence)
"P" = (
/obj/effect/baseturf_helper/dune,
/turf/closed/indestructible/oldshuttle,
/area/violence)
"Q" = (
/obj/vehicle/ridden/lavaboat/dragon,
/turf/open/lava/smooth,
/area/violence)
"U" = (
/obj/effect/turf_decal/pool{
	dir = 4
	},
/obj/effect/turf_decal/tile/red,
/obj/effect/turf_decal/tile/red{
	dir = 1
	},
/obj/effect/turf_decal/tile/red{
	dir = 8
	},
/obj/effect/turf_decal/tile/red{
	dir = 4
	},
/obj/structure/emergency_shield/barrier,
/turf/open/floor/plasteel/showroomfloor,
/area/violence)
"V" = (
/obj/structure/rack,
/obj/effect/turf_decal/siding/white{
	dir = 8
	},
/obj/item/oar,
/obj/item/oar,
/obj/item/oar,
/obj/item/oar,
/obj/item/oar,
/obj/item/oar,
/obj/item/oar,
/obj/item/oar,
/turf/open/floor/plasteel/showroomfloor,
/area/violence)
"W" = (
/obj/structure/emergency_shield/barrier,
/turf/open/floor/plasteel/showroomfloor,
/area/violence)
"X" = (
/obj/effect/turf_decal/siding/white{
	dir = 4
	},
/obj/item/oar,
/obj/item/oar,
/obj/item/oar,
/obj/item/oar,
/obj/item/oar,
/obj/item/oar,
/obj/item/oar,
/obj/item/oar,
/obj/structure/rack,
/turf/open/floor/plasteel/showroomfloor,
/area/violence)
"Y" = (
/turf/closed/indestructible/oldshuttle/corner{
	dir = 8
	},
/area/violence)

(1,1,1) = {"
P
a
a
a
a
a
a
a
a
a
a
a
a
a
a
a
a
a
a
a
a
a
a
a
a
a
a
a
a
a
a
a
a
"}
(2,1,1) = {"
a
G
G
G
G
g
g
g
W
M
M
M
M
M
M
M
M
M
M
M
M
M
M
M
W
g
g
g
G
G
G
G
a
"}
(3,1,1) = {"
a
g
g
g
g
g
g
g
W
M
M
M
M
M
M
M
M
M
M
M
M
M
M
M
W
g
g
g
g
g
g
g
a
"}
(4,1,1) = {"
a
J
J
J
J
J
J
J
a
B
B
B
a
U
U
U
U
U
U
U
a
B
B
B
a
J
J
J
J
J
J
J
a
"}
(5,1,1) = {"
a
s
s
s
s
s
s
s
a
c
c
V
a
J
J
J
J
J
J
J
a
V
c
c
a
s
s
s
s
s
s
s
a
"}
(6,1,1) = {"
a
s
s
s
s
s
s
s
a
f
f
v
a
s
s
s
s
s
s
s
a
v
f
f
a
s
s
s
s
s
s
s
a
"}
(7,1,1) = {"
a
s
s
s
s
s
s
s
a
f
f
v
a
s
s
s
s
s
s
s
a
v
f
f
a
s
s
s
s
s
s
s
a
"}
(8,1,1) = {"
a
s
s
s
s
s
s
s
a
f
f
Y
a
s
s
s
s
s
s
s
a
N
f
f
a
s
s
s
s
s
s
s
a
"}
(9,1,1) = {"
a
s
s
s
s
s
s
s
a
f
f
f
W
s
s
s
s
s
s
s
W
f
f
f
a
s
s
s
s
s
s
s
a
"}
(10,1,1) = {"
a
s
s
s
s
s
s
s
a
f
f
f
W
s
s
s
s
s
s
s
W
f
f
f
a
s
s
s
s
s
s
s
a
"}
(11,1,1) = {"
a
s
s
s
s
s
s
s
a
a
a
a
a
s
s
s
s
s
s
s
a
a
a
a
a
s
s
s
s
s
s
s
a
"}
(12,1,1) = {"
a
s
s
s
s
s
s
s
s
s
s
s
s
s
s
s
s
s
s
s
s
s
s
s
s
s
s
s
s
s
s
s
a
"}
(13,1,1) = {"
a
s
s
s
s
s
s
s
s
s
s
s
s
s
s
s
s
s
s
s
s
s
s
s
s
s
s
s
s
s
s
s
a
"}
(14,1,1) = {"
a
s
s
s
s
s
s
s
s
s
s
s
s
s
s
s
s
s
s
s
s
s
s
s
s
s
s
s
s
s
s
s
a
"}
(15,1,1) = {"
a
s
s
s
s
s
s
s
s
s
s
s
s
s
s
s
s
s
s
s
s
s
s
s
s
s
s
s
s
s
s
s
a
"}
(16,1,1) = {"
a
s
s
s
s
s
s
s
s
s
s
s
s
s
s
s
s
s
s
s
s
s
s
s
s
s
s
s
s
s
s
s
a
"}
(17,1,1) = {"
a
s
s
s
s
s
s
s
s
s
s
s
s
s
s
s
s
s
s
s
s
s
s
s
s
s
s
s
s
s
s
s
a
"}
(18,1,1) = {"
a
s
s
s
s
s
s
s
s
s
s
s
s
s
s
s
s
s
s
s
s
s
s
s
s
s
s
s
s
s
s
s
a
"}
(19,1,1) = {"
a
s
s
s
s
s
s
s
s
s
s
s
s
s
s
s
s
s
s
s
s
s
s
s
s
s
s
s
s
s
s
s
a
"}
(20,1,1) = {"
a
s
s
s
s
s
s
s
s
s
s
s
g
g
g
g
g
g
g
g
g
s
s
s
s
s
s
s
s
s
s
s
a
"}
(21,1,1) = {"
a
s
s
s
s
s
s
s
s
s
Q
g
g
g
g
g
g
g
g
g
g
g
Q
s
s
s
s
s
s
s
s
s
a
"}
(22,1,1) = {"
a
s
s
s
s
s
s
s
s
s
Q
g
g
g
g
g
g
g
g
g
g
g
Q
s
s
s
s
s
s
s
s
s
a
"}
(23,1,1) = {"
a
s
s
s
s
s
s
s
s
s
Q
g
g
g
g
g
g
g
g
g
g
g
Q
s
s
s
s
s
s
s
s
s
a
"}
(24,1,1) = {"
a
s
s
s
s
s
s
s
s
s
Q
g
g
g
g
g
g
g
g
g
g
g
Q
s
s
s
s
s
s
s
s
s
a
"}
(25,1,1) = {"
a
s
s
s
s
s
s
s
s
s
Q
g
g
g
g
y
g
i
g
g
g
g
Q
s
s
s
s
s
s
s
s
s
a
"}
(26,1,1) = {"
a
s
s
s
s
s
s
s
s
s
Q
g
g
g
g
g
k
g
g
g
g
g
Q
s
s
s
s
s
s
s
s
s
a
"}
(27,1,1) = {"
a
s
s
s
s
s
s
s
s
s
Q
g
g
g
g
L
g
F
g
g
g
g
Q
s
s
s
s
s
s
s
s
s
a
"}
(28,1,1) = {"
a
s
s
s
s
s
s
s
s
s
Q
g
g
g
g
g
g
g
g
g
g
g
Q
s
s
s
s
s
s
s
s
s
a
"}
(29,1,1) = {"
a
s
s
s
s
s
s
s
s
s
Q
g
g
g
g
g
g
g
g
g
g
g
Q
s
s
s
s
s
s
s
s
s
a
"}
(30,1,1) = {"
a
s
s
s
s
s
s
s
s
s
Q
g
g
g
g
g
g
g
g
g
g
g
Q
s
s
s
s
s
s
s
s
s
a
"}
(31,1,1) = {"
a
s
s
s
s
s
s
s
s
s
Q
g
g
g
g
g
g
g
g
g
g
g
Q
s
s
s
s
s
s
s
s
s
a
"}
(32,1,1) = {"
a
s
s
s
s
s
s
s
s
s
s
s
g
g
g
g
g
g
g
g
g
s
s
s
s
s
s
s
s
s
s
s
a
"}
(33,1,1) = {"
a
s
s
s
s
s
s
s
s
s
s
s
s
s
s
s
s
s
s
s
s
s
s
s
s
s
s
s
s
s
s
s
a
"}
(34,1,1) = {"
a
s
s
s
s
s
s
s
s
s
s
s
s
s
s
s
s
s
s
s
s
s
s
s
s
s
s
s
s
s
s
s
a
"}
(35,1,1) = {"
a
s
s
s
s
s
s
s
s
s
s
s
s
s
s
s
s
s
s
s
s
s
s
s
s
s
s
s
s
s
s
s
a
"}
(36,1,1) = {"
a
s
s
s
s
s
s
s
s
s
s
s
s
s
s
s
s
s
s
s
s
s
s
s
s
s
s
s
s
s
s
s
a
"}
(37,1,1) = {"
a
s
s
s
s
s
s
s
s
s
s
s
s
s
s
s
s
s
s
s
s
s
s
s
s
s
s
s
s
s
s
s
a
"}
(38,1,1) = {"
a
s
s
s
s
s
s
s
s
s
s
s
s
s
s
s
s
s
s
s
s
s
s
s
s
s
s
s
s
s
s
s
a
"}
(39,1,1) = {"
a
s
s
s
s
s
s
s
s
s
s
s
s
s
s
s
s
s
s
s
s
s
s
s
s
s
s
s
s
s
s
s
a
"}
(40,1,1) = {"
a
s
s
s
s
s
s
s
s
s
s
s
s
s
s
s
s
s
s
s
s
s
s
s
s
s
s
s
s
s
s
s
a
"}
(41,1,1) = {"
a
s
s
s
s
s
s
s
a
a
a
a
a
s
s
s
s
s
s
s
a
a
a
a
a
s
s
s
s
s
s
s
a
"}
(42,1,1) = {"
a
s
s
s
s
s
s
s
a
f
f
f
W
s
s
s
s
s
s
s
W
f
f
f
a
s
s
s
s
s
s
s
a
"}
(43,1,1) = {"
a
s
s
s
s
s
s
s
a
f
f
f
W
s
s
s
s
s
s
s
W
f
f
f
a
s
s
s
s
s
s
s
a
"}
(44,1,1) = {"
a
s
s
s
s
s
s
s
a
f
f
D
a
s
s
s
s
s
s
s
a
q
f
f
a
s
s
s
s
s
s
s
a
"}
(45,1,1) = {"
a
s
s
s
s
s
s
s
a
f
f
w
a
s
s
s
s
s
s
s
a
w
f
f
a
s
s
s
s
s
s
s
a
"}
(46,1,1) = {"
a
s
s
s
s
s
s
s
a
f
f
w
a
s
s
s
s
s
s
s
a
w
f
f
a
s
s
s
s
s
s
s
a
"}
(47,1,1) = {"
a
s
s
s
s
s
s
s
a
I
I
X
a
J
J
J
J
J
J
J
a
X
I
I
a
s
s
s
s
s
s
s
a
"}
(48,1,1) = {"
a
J
J
J
J
J
J
J
a
j
j
j
a
m
m
m
m
m
m
m
a
j
j
j
a
J
J
J
J
J
J
J
a
"}
(49,1,1) = {"
a
g
g
g
g
g
g
g
W
z
z
z
z
z
z
z
z
z
z
z
z
z
z
z
W
g
g
g
g
g
g
g
a
"}
(50,1,1) = {"
a
G
G
G
G
g
g
g
W
z
z
z
z
z
z
z
z
z
z
z
z
z
z
z
W
g
g
g
G
G
G
G
a
"}
(51,1,1) = {"
a
a
a
a
a
a
a
a
a
a
a
a
a
a
a
a
a
a
a
a
a
a
a
a
a
a
a
a
a
a
a
a
a
"}
